Title	Category
FLASH SALE | LIMITED TIME ONLY Shop Now	Urgency
Pillowcases & Shams	Not Dark Pattern
Write a review	Not Dark Pattern
To start your return, simply click on the following button and add your return details. Once the form is filled, you will receive an email with shipping instructions for how to ship the item(s) to our warehouse.	Not Dark Pattern
 newsletter signup (privacy policy) 	Not Dark Pattern
In demand	Scarcity
We cannot guarantee door to door delivery for every customer. Buyers in remote areas such as farms, islands, mining camps, small towns, or out-of-towners, etc may need to collect from their nearest freight depot.	Not Dark Pattern
Hurry! Only 2 left in stock	Scarcity
In Stock only 3 left	Scarcity
International Shipping Policy	Not Dark Pattern
Clothes, Shoes & Accessories	Not Dark Pattern
Hurry! Only 2 left	Scarcity
Primary Arms Scopes	Not Dark Pattern
ONLY 8 LEFT	Scarcity
MoTrail	Not Dark Pattern
LCD Ribbon Cables	Not Dark Pattern
READY FOR YOUR NEXT AUTHENTIC NHL JERSEY?	Not Dark Pattern
OUR BEST SELLING GOGGLE	Misdirection
1,142 people have added to cart recently	Social Proof
Limited Availability	Scarcity
No thanks. I don't like free things...	Misdirection
 read you will want to read -- Five Book Group Favourites * Sunday Post *	Not Dark Pattern
 Supply & Demand 	Not Dark Pattern
Michael in Pontiac, United States purchased a  	Social Proof
Bathroom Lighting	Not Dark Pattern
 Shop Optics > 	Not Dark Pattern
9 people are viewing this.	Social Proof
894 Claimed! Hurry, only a few left!	Scarcity
77 PEOPLE LIKE THIS	Social Proof
Girls Trousers	Not Dark Pattern
Specs	Not Dark Pattern
4 items left	Scarcity
HURRY! EXCLUSIVE DEAL FOR YOU! 1 4 : 4 5	Urgency
Offer ends in	Urgency
Another babe in Alexandria, United States just ordered Flat Tummy Tea	Social Proof
Someone in Boling Iago Texas United States Purchased Seek Discomfort Sketch White iPhone Case 5 hours ago	Social Proof
More Info	Not Dark Pattern
Daystate FAC Air Rifles	Not Dark Pattern
Keyboard Navigation Profile (Motor-Impaired): this profile enables motor-impaired persons to operate the website using the keyboard Tab, Shift+Tab, and the Enter keys. Users can also use shortcuts such as ‚ÄúM‚Äù (menus), ‚ÄúH‚Äù (headings), ‚ÄúF‚Äù (forms), ‚ÄúB‚Äù (buttons), and ‚ÄúG‚Äù (graphics) to jump to specific elements.	Not Dark Pattern
24 sold in last 24 hours.	Social Proof
 #CERTIFIED_FACE_MASKS 	Not Dark Pattern
Shop the Look	Not Dark Pattern
Kicks Remotes	Not Dark Pattern
Only 7 left in stock.	Scarcity
Whey Protein Isolate	Not Dark Pattern
 Cases for Magsafe Refine by Product Type: Cases for Magsafe 	Not Dark Pattern
Product Info	Not Dark Pattern
Someone from Norway purchased a Super FG Grater - 12x Faster - 15% OFF	Social Proof
 Sign In With Google 	Not Dark Pattern
Shop All	Not Dark Pattern
 You can change your preference here Shop for Select an age 	Not Dark Pattern
1 in Stock	Scarcity
 shop all 	Not Dark Pattern
Low Stock Alert: Only 8 left in inventory	Scarcity
Womens Platform Shoes	Not Dark Pattern
Screen print graphics	Not Dark Pattern
IBKUL Solid Mock Neck Half Zip Pullover purchased from Clinton, MD, US 1 minute ago	Social Proof
Thin and tough - protects from minor scratches	Not Dark Pattern
Kimberly R.	Not Dark Pattern
I don't feel lucky	Misdirection
Only 3 items left	Scarcity
 Butterscotch Cakes 	Not Dark Pattern
Someone in Saint Kilda, Victoria purchased Frank Queen Size Bed Base	Social Proof
Awntech New Yorker Window/Entry Slope Awnin ...	Not Dark Pattern
45 ADDED TO BAG IN THE PAST 24 HOURS	Social Proof
87% offers claimed. Hurry up!	Scarcity
HURRY! ¬£32.99 UK DELIVERY ENDS SOON	Urgency
ONLY 3 LEFT	Scarcity
8 items left	Scarcity
19 people viewed this product per day	Social Proof
 Irwin 	Not Dark Pattern
96 ITEM(S) LEFT IN STOCK!	Scarcity
__________	Not Dark Pattern
Only 1 left In Stock	Scarcity
Availability: Only 4 Left!	Scarcity
 Personalised Gifts 	Not Dark Pattern
A customer service specialist will contact you soon.	Not Dark Pattern
Your order is reserved for 09:54 minutes!	Urgency
 Screws & Other Fixings 	Not Dark Pattern
Use the domain shortly after payment	Not Dark Pattern
Office Supplies & Decor	Not Dark Pattern
This size has only 1 left in stock	Scarcity
Arrow	Not Dark Pattern
Returns an Item	Not Dark Pattern
HOT PRODUCT Over 250 people are looking at this item.	Social Proof
I don't want to save money	Misdirection
HURRY! ONLY 2 LEFT IN STOCK!	Scarcity
Hair type: Curly	Not Dark Pattern
DEAL ENDS IN 40:55:13	Urgency
Someone bought: HYPE BLUE LARGE SPLAT KIDS LEGGINGS	Social Proof
Only 1 Left	Scarcity
Search for similiar products	Not Dark Pattern
Only 33 left	Scarcity
FAMILY SHADE PACK | PICK YOUR PACK	Not Dark Pattern
Promaster City Remotes	Not Dark Pattern
Hurry, only a few left!	Scarcity
 V&A Collection People Tree‚Äôs collaboration with the Victoria and Albert Museum offers a stylish and contemporary capsule collection which celebrates the beauty and variety of pattern which the London museum is renowned for. 	Not Dark Pattern
Only 11 left!	Scarcity
Hurry! Only 6 left in stock	Scarcity
40 users are currently active on our website just now.	Social Proof
Hair Tools	Not Dark Pattern
Email Address*	Not Dark Pattern
 Send Us Your Jersey 	Not Dark Pattern
 View All Home Office Furniture 	Not Dark Pattern
Search Result:Search Results: 	Not Dark Pattern
90% offers claimed. Hurry up!	Scarcity
Tube Tops	Not Dark Pattern
"Mitchell H. Purchased a Dimplex IgniteXL 100"" Linear Built in Electric Fireplace"	Social Proof
Hair type: Wavy	Not Dark Pattern
7 people looked at this product in the last 24 hours.	Social Proof
Glow Gear	Not Dark Pattern
18 In Stock	Scarcity
Someone in New Lynn bought a Kogan A1 Earphones with Inline Control for IOS/Android 1 hour ago.	Social Proof
00:15:07:45	Urgency
No, I'll rather pay full price.	Misdirection
Only 9 Left.	Scarcity
Deals of the Week	Not Dark Pattern
 ... It covers love and loss, friendship and pain through 	Not Dark Pattern
1 person is viewing this	Social Proof
Your order is reserved for 09:14 minutes! 	Urgency
 Gift TypeFlowers, Cakes, Plants, etc. 	Not Dark Pattern
 CAMILLA World 	Not Dark Pattern
Sweep Train Simple A Line Tulle Wedding Dress with Appliques and Beading	Not Dark Pattern
Fun Treat Tossing	Not Dark Pattern
Limited time remaining!	Urgency
No thanks, I'll pay full price	Misdirection
Your shopping bag is empty...	Not Dark Pattern
Trousers & Chinos	Not Dark Pattern
Only 7 left in stock!	Scarcity
Only 5 item(s) left.	Scarcity
 Chargers 	Not Dark Pattern
(only 5 left)	Scarcity
 Eyelashes 	Not Dark Pattern
Pick the price that matches your budget. 	Not Dark Pattern
Bringing the latest footwear, ‚Äòfits and accessories from the biggest brands, the JD app makes coppin‚Äô the hottest looks even easier!	Not Dark Pattern
Child Safety	Not Dark Pattern
 Cosmic Rainbow 	Not Dark Pattern
NRA Annual Meetings & Exhibits	Not Dark Pattern
ShoesBootsCasual ShoesFormal ShoesSandals & Flip-flopsShoe Care & AccessoriesSlippersSneakers & CanvasSports Shoes	Not Dark Pattern
 Moonstone Beads 	Not Dark Pattern
I'll Shop Without A Discount	Misdirection
Only 11 Left In Stock	Scarcity
 Netherlands Antilles USD	Not Dark Pattern
Was this product description useful?YesNo	Not Dark Pattern
Returns Information	Not Dark Pattern
TiesToys & GamesTravelWatches	Not Dark Pattern
Bought by 39 people in last few hours! HOT SELLER!	Social Proof
Books and Stationery	Not Dark Pattern
Your order is reserved for 08:48 minutes!	Urgency
11 11 Hours: 00 22 Minutes: 3223 3223 Seconds	Urgency
 Bioactive Custodians 	Not Dark Pattern
 Most-Hearted Styles Shop Now 	Not Dark Pattern
 Use a clean vase and clean water.	Not Dark Pattern
 well, this is awkward. 	Not Dark Pattern
@elsieandpresley_ got some fantastic color results with our Hair Color Wax. Well done üëè	Not Dark Pattern
 All¬†Licensed 	Not Dark Pattern
Nursing chairs	Not Dark Pattern
Only 1 Item(s) left	Scarcity
Discount pending $10 OFF 00:30:00	Urgency
Juniors' Shoes	Not Dark Pattern
Limited Time: $10 Off! Discount Reflected In Price!	Urgency
Switchers	Not Dark Pattern
 Data Processor Privacy Policy: https://cookieinformation.com/cookie-and-privacy-policy 	Not Dark Pattern
Ribbons	Not Dark Pattern
By clicking Sign Up, you agree to receive marketing text messages from Southern Tide at the number provided, including messages sent by autodialer. Consent is not a condition of any purchase. Message and data rates may apply. Message frequency varies. Reply HELP for help or STOP to cancel. View our Privacy Policy and Terms of Service.	Not Dark Pattern
IN 43 PEOPLE'S SHOPPING BAG	Social Proof
 Amethyst Beads 	Not Dark Pattern
Down Jackets	Not Dark Pattern
Hurry up! Prices increase in 0 DAYS 11 HRS 59 MINS 55 SECS	Urgency
BERNARD in Philadelphia, United States purchased a	Social Proof
NO THANKS, I DON‚ÄôT MIND MISSING OUT	Misdirection
Hurry, only 1 left!	Scarcity
Only 26 Left	Scarcity
7 sold in last 24 hours	Social Proof
Buy Wearables¬ª	Not Dark Pattern
LAST CHANCE - UP TO 70% OFF - ENDS IN: 20 HRS 28 MINS 30 SECS	Urgency
 Watercolour Brushes Toggle category Watercolour Brushes 	Not Dark Pattern
LightInTheBox Êé≤ËºâË®ò‰∫ã	Not Dark Pattern
Clear filter	Not Dark Pattern
HURRY UP > 09H 42M 39S	Urgency
 Sweats 	Not Dark Pattern
Q:¬†Will this damage my hair?	Not Dark Pattern
Brandon Blackwood	Not Dark Pattern
Someone in Sasebo, Japan just bought	Social Proof
80 Customers are considering this product right now.	Social Proof
88 PEOPLE VIEWED ITEM IN THE LAST 24 HOURS	Social Proof
 End Tables	Not Dark Pattern
ONLY 2 LEFT IN STOCK!	Scarcity
Only few items left in stock	Scarcity
Only 1.75 yards left in stock!	Scarcity
 Brilliant! Chose what I wanted, and came a week later. Very happy with my purchase 	Not Dark Pattern
71 people have purchased this item	Social Proof
Only 8 left	Scarcity
Subscribe & Save	Misdirection
We use cookies to improve our services, make personal offers, and enhance your experience. If you do not accept optional cookies below, your experience may be affected. If you want to know more, please, read the Cookie Policy	Not Dark Pattern
Long Dress Style Beach Cover Up With Lace Detail Jessica in Metairie, United States	Social Proof
Someone in Kilwinning, United Kingdom just bought Cuban Link Chain Bracelet	Social Proof
00DAYS00HOURS14MINUTES21SECONDS	Urgency
Great prices, professional customer services	Not Dark Pattern
Carnival Remotes	Not Dark Pattern
Hurry! Only 1 left in size M!!	Scarcity
Items in your cart are in high demand.	Scarcity
 VIP Points! 	Not Dark Pattern
Root Touch Up + Brow Filler	Not Dark Pattern
Limited stock Only 2 left	Scarcity
 Looks like your cart is empty, let's fix that! 	Not Dark Pattern
Over 500 left in stock	Scarcity
Lasers 	Not Dark Pattern
Choose your payment day. View your schedule and select pay now.	Not Dark Pattern
Hurry up! 6 people other than you have this product in their cart	Social Proof
 E-Gift Cards 	Not Dark Pattern
1 LEFT	Scarcity
Leslie in USA just Purchased Special Design Exclusive Handmade Silver Ring	Social Proof
 Personalised Chocolates 	Not Dark Pattern
Shop Dresses by Occasion	Not Dark Pattern
I do not want to protect my item	Misdirection
Add to Your Gift and We'll Ship it For Free!	Misdirection
Wallets 	Not Dark Pattern
 Exclusive offers & discounts for club members via email 	Not Dark Pattern
Buy with humm.	Not Dark Pattern
 Household Cleaning Kitchen Bathroom Eco Laundry General Cleaning Kitchenware Cook & Bakeware Food Storage & Preservation Kitchen Textiles Appliances Kitchen Appliances Household Appliances Bed, Bath & Living 	Not Dark Pattern
Synthesis E-MTB Carbon Wheelset	Not Dark Pattern
25,439 people have viewed this item	Social Proof
No thanks I definitely measured correctly	Misdirection
57 PEOPLE HAVE LOOKED AT THIS TODAY	Social Proof
Theresa from Botkins just bought Panoply 14918 A-line Lace Formal Dress	Social Proof
Women's ApparelCollection 	Not Dark Pattern
Before you check out, can we tempt you?	Misdirection
 Women's Sandals 	Not Dark Pattern
 Plant-Based Beauty 	Not Dark Pattern
When you join the PetPlus Plan, you are given the option to purchase your membership on an annual or monthly basis and you are automatically enrolled in our recurring billing program. You may cancel at any time by contacting our customer service team, but you will not be refunded for any unused days on your membership if you choose to cancel prior to the end of your billing cycle. You may cancel your PetPlus membership at any time without penalty if you have not utilized any of your PetPlus benefits (including discounts on products and/or services). For customers charged on a monthly basis, if you have purchased products or used services using your PetPlus benefits, we will charge a $25 administrative fee per membership cancellation if the membership is cancelled within three months of enrollment.	Obstruction
 Frame out of stock in this colour	Not Dark Pattern
Hair Care Sets	Not Dark Pattern
Limited quantity remaining	Scarcity
CareersAbout UsAffiliatesPrivacy SettingsAdvertise with usHelpSite map	Not Dark Pattern
128 sold today! Hurry, only a few left!	Scarcity
4 people are looking at this right now.	Social Proof
No thanks, I dont want a discount	Misdirection
Someone from Portland, United States (US) purchased MODALERT recently.	Social Proof
Limited Time Offer Limited Offer! 15% off on Naomi Home with Coupon 9N03. You pay $63.74	Urgency
2 people are viewing this	Social Proof
HURRY! ONLY 1 IN STOCK!	Scarcity
Printed 	Not Dark Pattern
Patient Transfer Devices	Not Dark Pattern
 Summer Casual Printed Loosen Short Sleeve T-Shirt 	Not Dark Pattern
 Summer V Neck Solid Color Short Sleeve Waffle T-Shirt 	Not Dark Pattern
LAST CHANCE TO ACTIVATE 10% OFF	Scarcity
Your order is reserved for 09:45 minutes!	Urgency
only 5 left	Scarcity
78 Persons looking for this product	Social Proof
 Heart Shaped Cake 	Not Dark Pattern
227 Bought Already	Social Proof
You've made the starting lineup. Be on the look out for an exclusive offer for signing up.	Not Dark Pattern
Universal Fit Collapsible Smart Phone Stand	Not Dark Pattern
Hurry! Only Limited Items Left	Scarcity
Áèæ‰ª£Â•¥Èö∑Ê≥ï„Å´ÂØæ„Åô„ÇãÈÄèÊòéÊÄß„Å´Èñ¢„Åô„ÇãÂ£∞Êòé (opens in a new tab)	Not Dark Pattern
Strong demand! Complete your order before it's too late!	Scarcity
Your order is reserved for 09:56 minutes!	Urgency
Sudha rana from Jaipur bought this product, 23 Mins ago.	Social Proof
Gift Wrapping Supplies	Not Dark Pattern
6 others have already bought this deal today!	Social Proof
"""No Worry"" Membership Renewal We will bill your credit card on file at the introductory rate of $2.99 per month for the first year, for membership rewards and discounts. At the end of the introductory period, you'll be billed at the regular monthly rate of $3.99 per month. If you don't want your membership renewed, simply contact us and we will cancel your subscription. You will be refunded for the current month's membership fee, less any membership savings you have received. Exclusive Toll-Free Hotline Number Because we want your calls to get top priority, we have a special number for Value Club members only: 1-800-648-4282. Your call will be handled with the utmost promptness, courtesy and efficiency possible."	Obstruction
info@coolhockey.com	Not Dark Pattern
"LIMITED TIME OFFER 10% OFF - ENTER CODE \""CASES\"" AT CHECKOUT"	Urgency
 Safe & Secure Checkout 	Not Dark Pattern
GRACE from ORLANDO, United States bought Camouflage Jumpsuit 31 minutes ago          	Social Proof
Synne Kristine in Halden, bought Classic Bokksu Subscription (Billed Every 1 Month) (Ships every 1 Months) about 45 minutes ago	Social Proof
Wall Mounted Air Conditioners	Not Dark Pattern
803 Claimed! Hurry, only a few left!	Scarcity
Monira in Doha, Qatar purchased a LilyVanity‚Ñ¢ Velvet Box	Social Proof
Only 2 left!	Scarcity
3 PEOPLE VIEWING	Social Proof
No thanks, I‚Äôd rather pay full price.	Misdirection
Product Feature	Not Dark Pattern
Plant-based Protein	Not Dark Pattern
Parad Combo Deals 	Not Dark Pattern
Last Shape Guide	Not Dark Pattern
 Baby & Toddler Toys 	Not Dark Pattern
Shipping Insurance Remove Insurance	Sneaking
Clocks 	Not Dark Pattern
 Cat's Eye Beads 	Not Dark Pattern
Shop now. Pay later. Always interest-free	Not Dark Pattern
Stay with us in India	Not Dark Pattern
No thanks. I don‚Äôt want deals.	Misdirection
Wyse Thin Client	Not Dark Pattern
AdjustableBucketHeadbandsSale Items- View All -	Not Dark Pattern
 Every bicycle tells a story 	Not Dark Pattern
 This site uses cookies to provide and improve your shopping experience. If you want to benefit from this improved service, please opt-in. 	Not Dark Pattern
Add and save!	Misdirection
Intercoms & Doorbells	Not Dark Pattern
Boys Purple School Uniforms	Not Dark Pattern
RECENTLY VIEWED 2 others viewed this in the last few hours	Social Proof
2 viewed per hour	Social Proof
1 other customers have this item in their shopping cart	Social Proof
ONLY A FEW LEFT IN STOCK	Scarcity
1day21:04:58	Urgency
Fashion Forms	Not Dark Pattern
Stock Low : 6 items left.	Scarcity
NO, I'LL PAY FULL PRICE	Misdirection
Terrarium Light Canopies	Not Dark Pattern
HURRY, LOW IN STOCK!	Scarcity
Only 4 copies left	Scarcity
2 LEFT	Scarcity
Feedback	Not Dark Pattern
2 DAYS 13:06:13	Urgency
Receive news and updates on new products	Not Dark Pattern
5338 people bought this	Social Proof
2 left in stock	Scarcity
 dFresh - Fresh Products 	Not Dark Pattern
Thanks! -RMO Team	Not Dark Pattern
6,743 people have viewed recently	Social Proof
Selling fast!	Scarcity
Welcome To Hotter us	Not Dark Pattern
ON SALE: Select Seasonal T-Shirts only $19.99! Limited time only! Save Now!	Urgency
 To enable notifications, click 'Allow' when prompted. 	Not Dark Pattern
 PHX Mercury 	Not Dark Pattern
Easy Release Cleat Kit	Not Dark Pattern
111 people have purchased this item	Social Proof
Flowers Trivia:	Not Dark Pattern
Your order is reserved for 09:58 minutes!	Urgency
I've recommended The Keeper of Lost Things to everyone.	Not Dark Pattern
LIMITED TIME! - Save $5 OFF Orders $70+ Coupon: SAVE5 - PLUS - Free Gift on Orders $125+	Urgency
1 Netflix offer: Not available to customers with an active Netflix offer from Vodafone. Available only on Red+ Lite, Unlimited, Red+ Essentials and Red+ until the 8th of August 2019. Exit fee of $60 applies if you exit or transfer your plan before 6 months. Plan exit fees may also apply. Netflix Offer: One year Netflix ‚ÄòStandard‚Äô plan ($14.99 a month) credit will be applied to your Netflix account on activation. At the end of your credit, you will be charged at your Netflix plan rate unless you cancel your Netflix subscription. Cancel Netflix at any time. Netflix compatible device required. See eligible plans and full Netflix terms.	Sneaking
Celebrity Synthetic Wigs	Not Dark Pattern
1626 people seeing this product right now	Social Proof
Book picture is for illustrative purposes only, actual binding, cover or edition may vary.	Not Dark Pattern
 Glow Gear 	Not Dark Pattern
Converse	Not Dark Pattern
Stay Connected	Not Dark Pattern
Only 1 left in Stock	Scarcity
sales@ecklers.net	Not Dark Pattern
0 Days 2 Hours 57 Minutes 53 Seconds	Urgency
Sharmeen Atif From Karachi just bought Stylish Metal Glasses Frames For Kids-Assorted-NA7157	Social Proof
Only 34 Left!	Scarcity
William in Pago Pago, United States purchased a	Social Proof
No thanks, I don‚Äôt like fun and games.	Misdirection
PROTECT YOUR SOFA! Your Humblebum Sofa in Thatch house fabric will look wicked! Why not add Castelan Fabric Protection to cover your new squish machine against wine spillages, messy TV dinners, and other disasters for just just ¬£80?	Misdirection
Explore The NRA Universe Of Websites	Not Dark Pattern
New In Special Occasion	Not Dark Pattern
‚Ä∫ New Year, New Kit Sale	Not Dark Pattern
HURRY, ORDER WITHIN 16h 59m 06s TO GET 35% OFF EVERYTHING* EXCL SALE & BEAUTY ENTER: DOLL35	Urgency
 Title of Review 	Not Dark Pattern
We uses cookies (and similar techniques) to provide you with better products and services. Your permission will be confirmed if you continue using this website.Read more	Not Dark Pattern
LAST CHANCE TO SAVE... enter your email to Save 20% on your first order 00 hours :29 minutes :43 seconds	Urgency
OFFER EXPIRES IN: YES NO Want 10% Off Your First Order? 7 minutes 35 seconds	Urgency
Cellular/Honeycomb Shades	Not Dark Pattern
113 people have viewed in the last 24hrs	Social Proof
Epilepsy Safe Profile: this profile enables people with epilepsy to safely use the website by eliminating the risk of seizures resulting from flashing or blinking animations and risky color combinations.	Not Dark Pattern
Jamie in Nashville, United States purchased	Social Proof
Denise in Saluda, Virginia bought Terani Couture - 1911E9095 Embroidered Asymmetric Neck Mermaid Gown	Social Proof
Don't miss out! We've sold 38 in the last few days.	Social Proof
No, thank you. I prefer to pay the full price	Misdirection
No Thanks, I don't like exclusive deals.	Misdirection
Loading interface...	Not Dark Pattern
 SAF Warriors 	Not Dark Pattern
 Lens Manual Washer 	Not Dark Pattern
No thanks, I'd like 0% off	Misdirection
Warm Tips	Not Dark Pattern
 Our Carbon Footprint 	Not Dark Pattern
 Women's Summer New Clerk Large Size Loose Cotton And Linen Blouse 	Not Dark Pattern
Uncheck the box if you prefer not to receive email updates.	Misdirection
| Add to Compare	Not Dark Pattern
No Thanks, I Don't Want a Free Gift	Misdirection
 World of Sweats 	Not Dark Pattern
This item is in high demand.	Scarcity
Cargo Trousers	Not Dark Pattern
Hair Bundles With Closure	Not Dark Pattern
BreakThrough	Not Dark Pattern
ONLY 1 LEFT! GET IT NOW!	Scarcity
Our most recent customers are from New Rochelle, Roseville, and Brooksville	Social Proof
ShopClose menu	Not Dark Pattern
Used Rifles	Not Dark Pattern
ONLY 4 LEFT	Scarcity
Limited quantity! 	Scarcity
DON'T MISS ON THESE AWESOME ITEMS / DON'T MISS ON OUR TABLE DECORATION SYSTEM	Misdirection
Hurry! Only 15 left!	Scarcity
 Motocross Boots 	Not Dark Pattern
 Remove Product? 	Not Dark Pattern
 Nursery 	Not Dark Pattern
Footwear Accessories	Not Dark Pattern
Only a few more left!	Scarcity
0011Days:0088Hours:4411Minutes:21125445Seconds	Urgency
and future features included!	Not Dark Pattern
69 people are viewing this	Social Proof
Only 4 items left in stock.	Scarcity
Natural Backgrounds	Not Dark Pattern
Speed Lace Accessory Kit - Orange	Not Dark Pattern
No Thanks, I Prefer Paying Full Price	Misdirection
Package RecyclingWe do try when possible to reuse packaging from our own suppliers in order to send purchased items to our customers, we ask if the packaging is still in good condition after you've received your goods then please try to use it again or recycle if not possible.	Not Dark Pattern
Ends in 1 Days, 4 Minutes, 44 Seconds	Urgency
In Stock - Limited Quantity	Scarcity
on Freight	Not Dark Pattern
Canvas Wall Art	Not Dark Pattern
Only 8 left in stock. Almost Gone!	Scarcity
JFN V Neck Lace Cut-Out Basic T-Shirt/Tee	Not Dark Pattern
or	Not Dark Pattern
 Short Sleeve Dresses 	Not Dark Pattern
Limited time only: FREE SHIPPING on all orders, no minimum required!	Urgency
No thanks, I don't like promotions and exclusive content.	Misdirection
 Shop All Lehenga Choli 	Not Dark Pattern
Lack Of Color	Not Dark Pattern
 Eye Protection	Not Dark Pattern
10 Left	Scarcity
 REPLACE-WITH-DYANMIC-HOST-ID	Not Dark Pattern
TVs	Not Dark Pattern
Only 2 left	Scarcity
Temporary Tattoos	Not Dark Pattern
3Days01:49:51 Left	Urgency
Log in / Create an account	Not Dark Pattern
Your order is reserved for 07:28 minutes!	Urgency
 is full of sorrow and joy that weaves the life stories of its characters, exploring relationships, illness and loss * Manchester Weekly News *	Not Dark Pattern
OH SO POPULAR! 21 bought in the last 7 days.	Social Proof
No Thanks, I'll Pay Full Price	Misdirection
Card Storage	Not Dark Pattern
2 customers recently bought it	Social Proof
Only 1 left in stock	Scarcity
Horizon Wide Neck Sweatshirt	Not Dark Pattern
All Womens Accessories	Not Dark Pattern
Only 1 left in stock! Get in quick!	Scarcity
Strip Softbox	Not Dark Pattern
You left 2 items in your bag Released in: 29 minutes :07 seconds	Urgency
Your first payment will be due on the day of your purchase.*	Not Dark Pattern
7 people have it in their cart	Social Proof
Pre-order 3 left	Scarcity
Offer ends in 15hrs 1min 56sec!	Urgency
Hurry, this style is selling fast!	Scarcity
 Glows In The Dark 	Not Dark Pattern
Towel Rails & Racks	Not Dark Pattern
When you place healing crystals in a symmetrical fashion and activate it with a crystal wand, the pattern is charged to send messages to the universe. A healing crystal grid uses sophisticated symmetry for manifestation.	Not Dark Pattern
Hurry, only 3 left!	Scarcity
FREE NECKLACE FOR MOM 01Days 01Hrs 35Mins 02Secs	Urgency
Quick Release	Not Dark Pattern
Blonde/Bleached Hair:¬†All colors look great. Silver won't be prominent on bleached hair though.	Not Dark Pattern
Free Upgrade, Limited Time!\n*DISH Install Not Available*	Urgency
Chatting	Not Dark Pattern
Specialist Tools	Not Dark Pattern
 Menu Search 	Not Dark Pattern
 Fashion Bags 	Not Dark Pattern
No thanks, I don't like discounts	Misdirection
Going Fast: Limited Quantities Left!	Scarcity
 This is a green tea without the bitterness. 	Not Dark Pattern
Spring Styles 	Not Dark Pattern
Rate & Review 	Not Dark Pattern
You may cancel your JustFab VIP Membership at any time. There is absolutely no cancellation fee. If you would like to continue receiving selections, then just skip the month by clicking Skip This Month in your Boutique between the 1st and the 5th of the month. You won't be charged and no member credit will be generated for you. If you no longer want to skip the month, then call our Fashion Consultants on 020 36953830 (local rate) Mon-Fri 8:00AM to 8:00PM and Sat-Sun 10:00AM to 6:00PM or cancel your membership via chat.	Obstruction
Only 498 left	Scarcity
Cooper Remotes	Not Dark Pattern
Over 38 bought	Social Proof
 Mitre Saws 	Not Dark Pattern
Christian Dior	Not Dark Pattern
Share this product	Not Dark Pattern
 Space Heaters & Workshop Heaters 	Not Dark Pattern
Hurry! Only a few of these left	Scarcity
Only 2 Left!	Scarcity
Animals & Action Figures	Not Dark Pattern
only 2 left	Scarcity
Only 1 Item Left!	Scarcity
HAUTELOOK 04:53	Urgency
Only 1 item left	Scarcity
 WANNA COLLAB? 	Not Dark Pattern
 PopTop Refine by Product Type: PopTop 	Not Dark Pattern
* Limited Time Offer *\nFREE\nTLPWR1 Test Leads!	Urgency
Earn FanCash on all purchases!	Not Dark Pattern
Bob's Outreach 	Not Dark Pattern
Cleaning Brushes & Tools	Not Dark Pattern
Sunwayfoto	Not Dark Pattern
85 have it in their cart	Social Proof
If you wish to cancel your subscription, you can email us at getflat@flattummyco.com	Obstruction
No thanks. I'd rather pay full price.	Misdirection
Only 3 pieces in stock!	Scarcity
ONLY 3 LEFT IN STOCK.	Scarcity
Free Embroidery Patterns	Not Dark Pattern
Mixing & Measuring	Not Dark Pattern
Members may cancel their Membership at any time during their Membership term and receive a full refund, less any benefits/savings received in their current Membership term (for example, Buyer‚Äôs Club Discounts received or free shipping). Refunds for completed years completed will not be made, even if the Member did not use any of the benefits during the Membership term. To cancel your membership, please contact our customer service department by contacting us at 1-800-375-3006.	Obstruction
To qualify, simply verify your status during checkout on the payment step. We verify through ID.me, our trusted technology partner for secure digital identity verification. 	Not Dark Pattern
no thanks, I'll save money another day	Misdirection
Shopper from Saint John, NB viewed Lenovo ThinkCentre M710t 10M9000RUS Desktop Computer 3 minutes ago!	Social Proof
Only 2 Left In Stock	Scarcity
 Best-Selling Products 	Not Dark Pattern
LIMITED TIME ONLY!	Urgency
 Subscribe! Don‚Äôt be caught empty handed 	Not Dark Pattern
 Add to Cart 	Not Dark Pattern
Now 30% off - hurry, limited time offer!	Urgency
The requested page could not be found	Not Dark Pattern
 View In Your Room 	Not Dark Pattern
 EVO SP All EVO SP parts and accessories 	Not Dark Pattern
 Circa Punches 	Not Dark Pattern
 Riding Culture Neue Lifestyle-Marke bei motoin 	Not Dark Pattern
Ericdress Long Sleeve Mesh Off Shoulder Summer Dress	Not Dark Pattern
Green Tea is made up of properties that have been known to increase caloric expenditure as well as the metabolism of fat	Not Dark Pattern
COLLEGIATE	Not Dark Pattern
Sparkling Elegance	Not Dark Pattern
To add to Wishlist, please register or sign in.	Not Dark Pattern
HURRY! Only a few left in stock!	Scarcity
 New In Lunch Boxes 	Not Dark Pattern
 Cayman Islands USD	Not Dark Pattern
No Thanks, I rather pay full price	Misdirection
 View All Shoes 	Not Dark Pattern
Someone from Airdrie & 10820 others bought this item recently.	Social Proof
Rachel Comey	Not Dark Pattern
52 people are looking at this right now.	Social Proof
1 day 08:15:25	Urgency
estiven in Deer Park, United States purchased PreWash‚Ñ¢ 4 oz	Social Proof
Delivery & Offers Terms	Not Dark Pattern
Oscar from Cajamarca, Peru purchased	Social Proof
 New Arrivals	Not Dark Pattern
 Buy Tablets 	Not Dark Pattern
Only 3 Left	Scarcity
Present your Fave voucher (it's in the Purchases tab under My Fave) at the outlet.	Not Dark Pattern
ONLY 1 REMAINING	Scarcity
Point & Shoots	Not Dark Pattern
Already have an account?	Not Dark Pattern
 Mystic Topaz: Rings, Earrings, Necklaces and Bracelets 	Not Dark Pattern
Necessary Protection..	Misdirection
Joybird Design House	Not Dark Pattern
What is a cookie?	Not Dark Pattern
Someone in Spain purchased	Social Proof
LIMITED QUANTITY	Scarcity
View All Tops	Not Dark Pattern
02:06:40 left to buy	Urgency
Limited Edition Honeycomb Necklace (Bee Inspired) Someone purchased a Limited Edition Honeycomb Necklace (Bee Inspired)	Social Proof
NO THANKS, I'll PAY FULL PRICE	Misdirection
13 people have added this to their cart	Social Proof
Panther Anole	Not Dark Pattern
Last chance! Only 1 left	Scarcity
AccessoriesCar AccessoriesDressesFootwearHome & OfficeJacketsLawn & OutdoorsPantsPolosShirts & SweatersShortsSleepwear & UnderwearSwim CollectionTailgatingSale Items- View All -	Not Dark Pattern
Pay weekly 	Not Dark Pattern
YOU MAY CANCEL YOUR WINE CLUB MEMBERSHIP OR ANY HOLIDAY SHIPMENTS AT ANY TIME BY CONTACTING US AT 1-877-975-9463, AND WE WILL PROMPTLY STOP PROCESSING THE RECURRING PAYMENTS.	Obstruction
I have green eyes and with these bright green contacts makes my eyes look out of this world amazing. I love them and they have lasted months!!	Not Dark Pattern
Sale ends soon:	Urgency
Only 16531 items left in stock!	Scarcity
Want a special deal? Bundle and SAVE UPTO30%	Misdirection
4 people have purchased this item	Social Proof
BABY BOYSShoesClothingAccessories	Not Dark Pattern
NEED ADDITIONAL HELP?	Not Dark Pattern
These cookies are necessary for the website to function and cannot be switched off in our system. These cookies are usually only set in response to actions made by you which include a request for services, such as setting your privacy preferences or logging into your account.	Not Dark Pattern
Only 3 Left!	Scarcity
High-Waisted Shorts	Not Dark Pattern
 Sign In / Join 	Not Dark Pattern
We only have few stocks left for this product. Please don't miss the chance.	Scarcity
Click here to use our website with more accessibility support, for example screen readers	Not Dark Pattern
Your order is reserved for 09:35 minutes!	Urgency
LIMITED TIME ONLY *on select models	Urgency
 Mixed Media 	Not Dark Pattern
BE QUICK 00:57:33 DON'T MISS OUT	Urgency
New In 	Not Dark Pattern
Remove selected car filter	Not Dark Pattern
35% OFF EVERYTHING* EXCL SALE & BEAUTY ENTER: DOLL35 - HURRY! ENDS IN  16H 59M 06S	Urgency
Shipping and Duties	Not Dark Pattern
Order by these dates to get it by Valentine's Day.*	Not Dark Pattern
NFL Enterprises LLC. All Rights Reserved.	Not Dark Pattern
LOGIN/REGISTER	Misdirection
00Days17Hours12Mins13Secs	Urgency
 Women's Bags 	Not Dark Pattern
We're sorry, this store is closed.	Not Dark Pattern
3 people are looking at this item right now	Social Proof
Someone from Menlo Park, California just purchased Electric Skateboard Motor 6374 190KV.	Social Proof
Hurry, Limited Time Offer! 11:25	Urgency
 Search Close 	Not Dark Pattern
touching, funny and romantic	Not Dark Pattern
We'd like to keep you informed via email about product updates, upgrades, special offers and pricing. If you do not wish to be contacted via email, please ensure that the box is not checked.	Misdirection
Only 2 stock available	Scarcity
Hurry! Only 3 Left In Stock.	Scarcity
‚óäAfter 1 year, subscription auto renews with fee. Review your iFit¬Æ Coach account on a computer, tablet, smartphone, or equipment console.	Sneaking
 Sorry, we could not process your request at the moment. Please try again in a few minutes. 	Not Dark Pattern
 Jersey GBP	Not Dark Pattern
My Account 	Not Dark Pattern
No Thanks, I Don't Want a Discount	Misdirection
Hair Grooming Appliances	Not Dark Pattern
WOULD YOU LIKE A FREE NEXT DIRECTORY? Explore all the latest collections from your free Next Directory. By opting in to receive the Next Directory you agree that we may send you, at our discretion, further Directories usually in January and July each year, at a charge of ¬£3.75 per publication. You also agree to receive supplementary Directories and ‚ÄòNew In‚Äô publications at no additional charge.	Sneaking
Pedal Refresh Kit - Doubleshot	Not Dark Pattern
I'd rather pay full price	Misdirection
Hurry up! Sales Ends in DAYS HRS MINS SECS by Beeketing 	Urgency
Only 8 items left in stock!	Scarcity
ONLY 1 LEFT IN STOCK!	Scarcity
Subscribe & Save (15%): $ 16.99	Misdirection
Shop Plus Shorts by Pattern	Not Dark Pattern
 Dry Direct Incontinence Personal Care Daily Living Safety Bedroom Nutrition Mobility Lift Aids Medical Supplies Plus Size 	Not Dark Pattern
Clarity Remotes	Not Dark Pattern
Summary	Not Dark Pattern
 Limited Edition Colors 	Not Dark Pattern
For instance, we use cookies allowing us to remember information provided by the users from a page to another, choices made by users and information provided by users (name, language preference, country of residence‚Ä¶). In particular, we use the following functional cookies: 	Not Dark Pattern
FRAMON #2 Code Machine Offer - Limited time offer!	Urgency
Jewelry and Watches	Not Dark Pattern
Limited stock!	Scarcity
Hurry! Only 2 left in stock!	Scarcity
*	Not Dark Pattern
SLEEP EVENT OFFERS - LIMITED TIME ONLY	Urgency
This chart should be used as a guide only. Due to each manufacturer‚Äôs size scale inconsistencies may occur.	Not Dark Pattern
Only 1 left in Stock!	Scarcity
Competitions	Not Dark Pattern
 Shop All Men's Boots 	Not Dark Pattern
Expand My eBay	Not Dark Pattern
Oliver in Rotterdam, Netherlands purchased a England Away Soccer Shorts 2018 About 9 hours ago	Social Proof
Jumpers, Shirts & T-Shirts	Not Dark Pattern
Media Players	Not Dark Pattern
Only 3 left In Stock	Scarcity
Father's Day Gifts	Not Dark Pattern
Enjoy FREE shipping with WSJwine Advantage	Sneaking
only 2 left!	Scarcity
Only 1 in stock	Scarcity
Only 8 item(s) left.	Scarcity
Spring Sale Extended	Urgency
No, I don't want a discount	Misdirection
No thanks, I don't want the free gift.	Misdirection
Extra Soft Cleansing Wipes	Not Dark Pattern
Men's Accessories 	Not Dark Pattern
jennifer just bought Rainbow Moonstone Healing Heartabout 6 hours ago	Social Proof
SAVE $300.00\nfor limited time	Urgency
Enter Catalog/Email Code	Not Dark Pattern
[NO THANKS, I'LL JUST WALK]	Misdirection
Yaris Remotes	Not Dark Pattern
Currently 8 left in stock.	Scarcity
NO, I DON'T FEEL LUCKY	Misdirection
Currently less than 10 available	Scarcity
Ends Sunday! $200 off any mattress . free shipping & free returns!	Urgency
Stay on Next.co.uk	Not Dark Pattern
Only 8 left!	Scarcity
Only 1 items left in stock!	Scarcity
___	Not Dark Pattern
View All Home Accessories	Not Dark Pattern
Healing Crystals are natural beings just like the trees, mountain or flowers. The result of diverse chemical reactions inside the earth over a millennium, gemstones are a true wonder of nature. When you touch a healing crystal, there is a transfer of heat and energy that leads to activation of chakra points. These therapeutic powers noticed in the presence of gemstones are the reason they are called healing crystals. With some crystals as old as the earth, there is immense wisdom in crystal use.	Not Dark Pattern
How to cast on	Not Dark Pattern
Tree Frog Terrariums	Not Dark Pattern
9 people are currently viewing this product	Social Proof
ONLY 1 WATCH LEFT	Scarcity
2+ people just viewed this product	Social Proof
94% offers claimed. Hurry up!	Scarcity
I'D RATHER PAY FULL PRICE	Misdirection
KidsAuthentic	Not Dark Pattern
*** Get 50% Off Your 2nd Case OR a Canopy Screen Protector *** A 50% OFF discount will be automatically applied to the lowest priced item in your cart when you check out with more than one item! (excludes Clearance items) Click to Choose Another Item	Misdirection
Country (Optional)	Not Dark Pattern
Hair treatments	Not Dark Pattern
Product Recycling	Not Dark Pattern
Purchase protection added	Sneaking
Only 6 items left	Scarcity
39 people have this in their cart	Social Proof
 Sunflower 	Not Dark Pattern
23% left in stock!	Scarcity
Gold Collection	Not Dark Pattern
In Stock. Only 1 Left!	Scarcity
Status:Only 3 left in stock	Scarcity
No thanks - I don't want to save money	Misdirection
Amazing service and quality! Lee up the excellent work.	Not Dark Pattern
Today's sale ends in: 00hours:57min:19sec	Urgency
ONLY 7 LEFT!	Scarcity
Business, Office & Industrial	Not Dark Pattern
My Story	Not Dark Pattern
8 people are looking at this artwork	Social Proof
 Coffee 	Not Dark Pattern
Add on something to make it extra special!	Misdirection
 Take time to pay.	Not Dark Pattern
OFFER ENDS 00:54:59	Urgency
Other Items On Special Offer:	Misdirection
You may change the items in your order, or cancel the Smartship at anytime, up until 3 days prior to the scheduled ship date of your Smartship by calling Customer Service at 1-800-518-0284.	Obstruction
LIMITED TIME SALE	Urgency
NO THANKS, I DON'T WANT TO SAVE	Misdirection
Authenticity Guaranteed	Not Dark Pattern
 GeekVape Pursue a Healthy Vaping Experience 	Not Dark Pattern
320 items left	Scarcity
HURRY! 3 left in stock!	Scarcity
Nectar	Not Dark Pattern
 My Project Lists 	Not Dark Pattern
Adjustable Cuffs With Inner Knitted Cuff	Not Dark Pattern
Tribeca Remotes	Not Dark Pattern
Brand 	Not Dark Pattern
I would like to join Backstage Pass & agree to the Terms & Conditions & to receive emails & other promotional offers.	Forced Action
The Dry Direct Ultimate is a great product, the best we have found. Customer service is very efficient, and deliveries have always been on time. We are very satisfied with Parentgiving in all aspects.	Not Dark Pattern
(ONLY 1 LEFT IN THIS SIZE!)	Scarcity
Only 65 Items Left.	Scarcity
Only 3 left in stock.	Scarcity
I Don't Like to Save Money	Misdirection
In Stock, Only 1 Left!	Scarcity
Really good quality contacts and they work well on my eyes. Would definitely order again!!!!	Not Dark Pattern
Explosive Offers! 80% Off Everything 07:25:41	Urgency
Warne Mounts	Not Dark Pattern
Report a Fake Product	Not Dark Pattern
 Shop All NFL 	Not Dark Pattern
Tapestry Guide	Not Dark Pattern
Only 4 left	Scarcity
I absolutely loved it! It made everyone laugh and my desk gets an obscene amount of compliments for it. The quality is superb! I am now definitely going to be a loyal shopper at PosterGully	Not Dark Pattern
Decades Shop	Not Dark Pattern
I'LL PAY FULL PRICE	Misdirection
gifts for wife	Not Dark Pattern
Hurry only 1 left!	Scarcity
Only 8 item(s) left	Scarcity
No thanks, I‚Äôd rather not win.	Misdirection
LOW IN STOCK, only 2 left	Scarcity
74% offers claimed. Hurry up!	Scarcity
Color Block	Not Dark Pattern
I'd rather not save	Misdirection
Only 2 left in stock!	Scarcity
You have no items in your basket.	Not Dark Pattern
no thanks, I hate fun & games	Misdirection
00 Days 02 Hrs 26 Mins 12 Sec Sale Ends Once The Timer Hits Zero!	Urgency
Soft Flexible (Classic) 	Not Dark Pattern
Glasses and Goggles	Not Dark Pattern
 Zero Gravity Lift Chairs 	Not Dark Pattern
Bobby in Decatur, United States just purchased	Social Proof
tuvia eisenberg Systematics in Tel Aviv, Israel purchased a	Social Proof
Your Cart Will Expire In 09:58 minutes!Please note that these items may not be available again if you release them.	Urgency
All Cross Stitch Patterns	Not Dark Pattern
 Year of Ours 	Not Dark Pattern
Gear Up	Not Dark Pattern
Weight Management Shakes help cut cals, control appetite, and drop LBS.* Learn more about Weight Management Shakes.	Not Dark Pattern
Tretorn	Not Dark Pattern
 Loyalty Points 	Not Dark Pattern
 How to Recycle 	Not Dark Pattern
 Color Yellow Smoke Blue Pink Orange	Not Dark Pattern
SAVE 10% On All Orders. No Voucher Code Needed Expires in 18:07:59.	Urgency
Art & Crafting Tools	Not Dark Pattern
One customer bought this article in the last 53 min.	Social Proof
 Highlight Hover 	Not Dark Pattern
 Disposable Washcloths 	Not Dark Pattern
Accuscreens	Not Dark Pattern
 Jumpers + Sweaters 	Not Dark Pattern
 Contact Lens Washer 	Not Dark Pattern
Only 9 Left!	Scarcity
Hurry! Only 2 left!	Scarcity
2 people are looking at this listing now	Social Proof
Every Purchase Helps Your NRA:	Not Dark Pattern
1 left at this price	Scarcity
 BACK TO TOP 	Not Dark Pattern
ONLY 12.5M LEFT IN STOCK!	Scarcity
Protect Your Gear	Misdirection
 Outdoor Recreation 	Not Dark Pattern
Allow All	Not Dark Pattern
We are currently accepting and processing orders from following:	Not Dark Pattern
What could have caused this?	Not Dark Pattern
210+ bought	Social Proof
No thanks, I'm not interested in saving money.	Misdirection
 SHIPPING INFO 	Not Dark Pattern
Plus, get free shipping on your first order!	Not Dark Pattern
BMW Remotes	Not Dark Pattern
All You‚Ñ¢	Not Dark Pattern
Someone in Mount Louisa bought a Coleman Folding Table & Bench Set 2 minutes ago	Social Proof
 Summer Casual Printed Short Sleeve T-Shirt 	Not Dark Pattern
¬†Join NRA or Renew	Not Dark Pattern
Don't forget the essentials Get up to 2 years of accidental damage coverage with AppleCare+.	Misdirection
Know exactly what‚Äôs going on at home and be alerted of emergencies in real time. 	Not Dark Pattern
Become an Affiliate	Not Dark Pattern
Competitor Price: $172.00	Misdirection
No thanks, I'd rather pay more	Misdirection
6 items left! Order soon.	Scarcity
Sports 	Not Dark Pattern
ONLY 20 LEFT IN STOCK	Scarcity
Immunity & Well BeingLean Muscle MassWeight LossBulk GainStress & Relaxation	Not Dark Pattern
By Brand All Men's Brands 	Not Dark Pattern
Customer Feedback	Not Dark Pattern
 Read the FAQ 	Not Dark Pattern
ONLY 1 LEFT	Scarcity
No thanks, I don't want 15% off	Misdirection
The presence of flowers is enough to make any occasion or moment truly a memorable affair. Flowers can make an ordinary room extremely beautiful. Flowers are widely used in decorations, as gifts, or even as ornaments on various dresses. People can explore a variety of fresh vibrant flowers such as roses, tulips, orchids, carnations, sunflowers, chrysanthemums and a lot more through the help of our online gifting store. All these beautiful flowers will be delivered at your desired destination in blooming condition only. With an unmatched beauty and fragrance, these gorgeous and lovely flowers can easily mesmerise any individual in an effortless manner.	Not Dark Pattern
Ashley in Auburn, United States purchased a Check Plz iPhone X/Xs Case about 24 minutes ago	Social Proof
99 people are looking at this right now	Social Proof
Someone from South Gate, California just purchased the Admiral JR / Spektrum Servo Connector Plug Set (Male and Female - 2 Pairs)	Social Proof
Medium GreyLogan T-Shirt Jersey Comforter and Sham Set	Not Dark Pattern
 All Birthday Gifts 	Not Dark Pattern
Rainbow Li	Not Dark Pattern
‚Ä¢ Recommended to be used with Downy for better long lasting freshness 	Not Dark Pattern
cookie host	Not Dark Pattern
Only 4 left!	Scarcity
Almost Sold Out! Only 2 Left.	Scarcity
Pay With:	Not Dark Pattern
Days left until the offer ends: 00 Days 04:43:35	Urgency
 Data Processor Privacy Policy: https://videoly.co/privacy-policy 	Not Dark Pattern
 School Shoes	Not Dark Pattern
 V-neck Casual Loose Embroidered Short Sleeve Blouse 	Not Dark Pattern
Spin to unlock your mystery offer	Misdirection
Only 2 items left in stock.	Scarcity
104 people viewed this product recently!	Social Proof
Material: Made with Cordura fabric	Not Dark Pattern
Armin Dinovic bought 10M Runescape 3 Gold Order total: 3,70‚Ç¨ About 10 seconds ago	Social Proof
Recent searches	Not Dark Pattern
Gorgeous, lasting high-quality hair color‚Äîcrafted in Italy.	Not Dark Pattern
Only A Few Left	Scarcity
 Apple iPhone X ¬ª 	Not Dark Pattern
Rebecca in Buffalo just bought Sateen Twill Swatchabout 1 hour ago	Social Proof
Certified Face Masks	Not Dark Pattern
 Price Low To High 	Not Dark Pattern
1 in stock	Scarcity
Leah Rich in Louisville, United States purchased a	Social Proof
Home + Tech Almost Gone	Not Dark Pattern
SAVE TODAY: Save 20% on lighting by Le Klint. Limited time only.	Urgency
Only 3 Left! Get it before it`s gone!	Scarcity
No thanks, I'll be the last to know.	Misdirection
Hurry Up ! Just 2 Items Left in stock	Scarcity
Toe Ring	Not Dark Pattern
Women's Acid Wash Scoopneck Sweater	Not Dark Pattern
62 people have looked at this item in the last few hours.	Social Proof
Boys Grey School Uniforms	Not Dark Pattern
8 customers have bought today	Social Proof
My Reviews	Not Dark Pattern
Last 1 in stock	Scarcity
Skin Concerns	Not Dark Pattern
Only 1 left!	Scarcity
Only a few left	Scarcity
Romper Swimwear	Not Dark Pattern
 View All Mattress Accessories 	Not Dark Pattern
The page you were looking for doesn't exist.	Not Dark Pattern
A very fun outfit for a less formal event like a sangeet! Husband said the bell bottom type pants were fun to dance in :)	Not Dark Pattern
 Chair Accessories 	Not Dark Pattern
No Thanks, I'll let this offer sail away	Misdirection
Stay in the Know	Not Dark Pattern
 V-neck Casual Loose Vintage Print Short Sleeve T-shirt 	Not Dark Pattern
Limited stock available	Scarcity
Thank you for posting a question!	Not Dark Pattern
Installation InstructionsPolicies & Terms of UseFinancingSite Map	Not Dark Pattern
Golf Shop	Not Dark Pattern
 Plastic 	Not Dark Pattern
Synthesis XCT Alloy Front Wheel	Not Dark Pattern
Hugs and Kisses Rose Bouquet $44.99 Discount -$6.75 Delivery $13.99 Tax $3.46 Item Total $55.69	Sneaking
Shop Tops by Pattern	Not Dark Pattern
Striped Tops	Not Dark Pattern
My AccountSign-in to your account	Not Dark Pattern
Due To HIGH Demand, Cart Expires In: 08:41	Urgency
ONLY 3 LEFT! GET IT NOW!	Scarcity
5 people are looking at this product right now	Social Proof
 Get The Look The Full Story Shop Now Read More 	Not Dark Pattern
Don‚Äôt worry. We‚Äôve got your back.	Not Dark Pattern
Hurry up! Discount Ends in DAYS HRS MINS SECS	Urgency
Extremely high demand: expect 2-4 weeks for it to arrive (to be safe). Limit 4 per person!	Scarcity
 C.P. Company 	Not Dark Pattern
In other users' carts 59	Social Proof
Nicholas Kirkwood	Not Dark Pattern
Aids mental processing‚Ä†	Not Dark Pattern
Awhi from Hicks Bay, Gisborne, New Zealand just bought	Social Proof
 Crossbody & Belt Bags 	Not Dark Pattern
clear text 	Not Dark Pattern
24 people currently interested	Social Proof
 Worldwide 	Not Dark Pattern
IF YOU PARTICIPATE IN AN AUTOMATIC RENEWAL SUBSCRIPTION AND YOU HAVE PROVIDED US WITH A VALID CREDIT CARD NUMBER OR AN ALTERNATE PAYMENT METHOD, EACH SHIPMENT WILL BE AUTOMATICALLY PROCESSED AT THE TIME OF EACH SHIPMENT OR INSTALLMENT AND WILL BE BILLED TO THE PAYMENT METHOD YOU PROVIDED TO US AT THE TIME OF YOUR INITIAL PURCHASE AND AGREEMENT TO PARTICIPATE IN THE PROGRAM. IF YOU WISH TO CANCEL YOUR PARTICIPATION IN AN AUTOMATIC RENEWAL SUBSCRIPTION, YOU MAY DO SO AT ANY TIME BY CONTACTING A CUSTOMER CARE PROFESSIONAL AT THE CONTACT INFORMATION PROVIDED ON THE WEBSITE.	Obstruction
AboutOur StoryOur MissionOur ProductsIn the News	Not Dark Pattern
5 Viewing This Product	Social Proof
23 People viewing this product	Social Proof
Activate within 0:30:00	Urgency
Concrete Tools	Not Dark Pattern
Transmission and Driveline	Not Dark Pattern
James in Cashion, Oklahoma just bought Glossy Black Brick Geode / Amber Gradient Fast Lanes	Social Proof
Fast Mover: 35 PEOPLE added this to cart today!	Social Proof
Metal - Brass , hollow from inside¬†	Not Dark Pattern
No thank you, I prefer to pay full price	Misdirection
 to read up about	Not Dark Pattern
‚Ä¢ State-by-State Restrictions	Not Dark Pattern
DON'T LET 'EM GET AWAY Several people have recently viewed this item.	Social Proof
No thanks. I prefer paying full price.	Misdirection
Crystal Li in Flushing, United States purchased a	Social Proof
Only 5 Left in Stock. Buy Soon!	Scarcity
 PG Picks: Skin Care for Incontinence 	Not Dark Pattern
Carl F. from Fort Ann, NY bought a King	Social Proof
137 users are currently active on our website	Social Proof
Reloading Tools	Not Dark Pattern
Edwin in Woodland Park, NJ just bought	Social Proof
Returns / Warranty	Not Dark Pattern
83% offers claimed. Hurry up!	Scarcity
Loading	Not Dark Pattern
Institute for Legislative Action	Not Dark Pattern
Clearance! Only 4 left in stock.	Scarcity
from Korea, South	Not Dark Pattern
Jeremy in Stockton, United States purchased a	Social Proof
Only 4 Left!	Scarcity
 Alchemy Books 	Not Dark Pattern
When you visit any website, it may store or retrieve information on your browser, mostly in the form of cookies. This information might be about you, your preferences or your device and is mostly used to make the site work as you expect it to. The information does not usually directly identify you, but it can give you a more personalized web experience. Because we respect your right to privacy, you can choose not to allow some types of cookies. Click on the different category headings to find out more and change our default settings. However, blocking some types of cookies may impact your experience of the site and the services we are able to offer. 	Not Dark Pattern
Only 1 products left	Scarcity
1 left in stock	Scarcity
üî• 9 people are viewing this.	Social Proof
715 people have added this item to cart	Social Proof
 Black / White Refine by Color: Black / White 	Not Dark Pattern
Call It Spring	Not Dark Pattern
Bathroom Basins	Not Dark Pattern
Infrared Night Vision	Not Dark Pattern
Download mobile app	Not Dark Pattern
 Write a reviewAsk a question	Not Dark Pattern
00DAYS02HRS14MINS1211SEC	Urgency
RegionBracket Right	Not Dark Pattern
Boxster Remotes	Not Dark Pattern
24 people have purchased this wine today	Social Proof
Rare Book Conditions 	Not Dark Pattern
Hurry! Less than 10 left!	Scarcity
I DON'T LIKE FREE GIFTS, NO THANKS	Misdirection
We don't give out your details to third parties.	Not Dark Pattern
Short Sleeve T-Shirts 	Not Dark Pattern
ONLY 13 LEFT	Scarcity
Someone in Yanchep bought a 52mm Mechanical 'Performance' Boost Gauge - Blue/White 9 seconds ago	Social Proof
 Tires	Not Dark Pattern
Someone in Egypt bought	Social Proof
mark in richmond hill, United States purchased a Fugoo Tough 11 minutes ago	Social Proof
Bearded Dragon Substrates	Not Dark Pattern
Toddler Girl Jumpsuits and Rompers	Not Dark Pattern
Enable cookies to use the shopping cart	Not Dark Pattern
Women's Go-Tos	Not Dark Pattern
This genuine Spanish espadrille impressed our buyers so much they ordered them in a variety of gorgeous colours. With its uncomplicated design, plush leather sole and a practical platform wedge, you'll have a hard time getting through the warmer months without them. They're perfect for the beach, casual weekend barbeques or brunch with the girls.	Not Dark Pattern
HURRY! DON'T MISS THIS DEAL! DAYS 0 1 HRS 1 2 MINS 3 1 SECONDS	Urgency
No, I'd rather pay full price.	Misdirection
Shopping with JD	Not Dark Pattern
 All Brands A-Z 	Not Dark Pattern
 Light Blue Regular Fit Single Cuff Easy Care Shirt 	Not Dark Pattern
Crop Tops	Not Dark Pattern
Photography Projector	Not Dark Pattern
 Salt Bender Tank and Shorts Combo 	Not Dark Pattern
Diamond Nose Studs 	Not Dark Pattern
 Military Discount 	Not Dark Pattern
Customize your phone with hundreds of grips, cases, wallets, and more.	Not Dark Pattern
5338 people viewed this in the last hour	Social Proof
Only 1 item left in stock	Scarcity
 Add to Wish List Add to Compare 	Not Dark Pattern
No Thanks, I don't want a discount	Misdirection
Availability: In Stock Hurry! Only 8 Left!	Scarcity
 Italy ‚Ç¨ EUR 	Not Dark Pattern
Politics And Legislation	Not Dark Pattern
Fewer than 5 left!	Scarcity
 Gift Cards Collection 	Not Dark Pattern
No Thanks, I prefer paying full price.	Misdirection
We guarantee to match a lower online price.	Not Dark Pattern
Hurry, before it is gone! Limited time remaining!	Urgency
Keith in Champaign, Illinois bought Mini USB Audio Cassette to MP3 Converterabout 56 minutes ago	Social Proof
Select your size below and we'll email you if it comes back in stock!	Not Dark Pattern
Only 867 left	Scarcity
About Cheryl's Business Gifts	Not Dark Pattern
Only 2 units left in stock	Scarcity
You can either livechat or email our support team with any questions or concerns. We are always ready to help. 	Not Dark Pattern
Only one item left in stock!	Scarcity
Synthesis E-MTB Alloy Rear Wheel	Not Dark Pattern
LIMITED TIME DEAL!	Urgency
Only 3 available	Scarcity
Only 1 left in online stock	Scarcity
Great for shine	Not Dark Pattern
 Learn More 	Not Dark Pattern
 Paper, Pads & Blocks Toggle category Paper, Pads & Blocks 	Not Dark Pattern
Hurry! Almost Sold Out...	Scarcity
. 	Not Dark Pattern
Only 2 copies left	Scarcity
Christmas Craft Ideas	Not Dark Pattern
Limited Quantity Available	Scarcity
No Thanks, I Don't Like Exclusive Offers.	Misdirection
Trey in Sparta, United States purchased Stealth Angel Ultra Lightweight & Portable Sleeping Bag about 45 minutes ago	Social Proof
2 items left	Scarcity
PomeloFashion born in AsiaOn trend. Online. On the go.	Not Dark Pattern
Available, only 2 left	Scarcity
Someone in San diego, United States just bought Gemfield Watch 15 days ago	Social Proof
Cowgirls	Not Dark Pattern
 Rs INR 	Not Dark Pattern
- +	Not Dark Pattern
If I emailed you how much I love each jersey you‚Äôd have an essay coming your way!	Not Dark Pattern
 Shirts & Blouses 	Not Dark Pattern
JFN Ladies Flat Embroidered Slip-On Dirty Shoes Vintage Thong Sandals	Not Dark Pattern
 New in 	Not Dark Pattern
There is no commitment and no minimum to buy. Please note exact shipment times may vary. To customize this program or future shipments, call customer service anytime at 1-800-THICKEN (844-2536).	Obstruction
About Bob's	Not Dark Pattern
22 people have looked at this part recently	Social Proof
Limited Time!	Urgency
4 sold in last 5 hours	Social Proof
Collin P. from Grandview Missouri just bought BURGUNDY TWO BUTTON SUIT ABOUT 5 SECONDS AGO	Social Proof
Your order is reserved for 08:53 minutes!	Urgency
 Rudraksha Recommendations 	Not Dark Pattern
OFFER ENDS: 09h: 09m: 55s: 0 	Urgency
 Added to Favorites 	Not Dark Pattern
Kamal in Lathrop, United States purchased a Father Sons Super Slim Stretch Feather Print Long Sleeve - FS429 4 hours ago	Social Proof
Brown Dresses	Not Dark Pattern
Someone in city just added Radiance - Nebulizing Diffuser¬Æ to their cart	Social Proof
They look really good with my brown eyes, and they look pretty natural.	Not Dark Pattern
 Data Processor Privacy Policy: https://www.appnexus.com/corporate-privacy-policy 	Not Dark Pattern
Hurry! Only 1 Pair left!	Scarcity
Plus Size Graphic Tops	Not Dark Pattern
Protection Filters	Not Dark Pattern
Flash Sale - Almost Over! 00 HOURS : 55 1001 MINUTES : 0550 8778 SECONDS	Urgency
Interactive Tent Finder	Not Dark Pattern
Cart will expire in 04:53 minutes!	Urgency
‚úï	Not Dark Pattern
Hurry, Only 4 Left In Stock. Buy Now!	Scarcity
take me back to shopping	Not Dark Pattern
Only 7 left	Scarcity
89% offers claimed. Hurry up!	Scarcity
No thanks, I hate cool stuff	Misdirection
Cheryl in Ontario bought 100% Organic Reishi Mushroom Powder 100g about 16 minutes ago	Social Proof
20 units left	Scarcity
High demand	Scarcity
3642 BOUGHT	Social Proof
5 in stock	Scarcity
"Nancy in Pennsylvania purchased 24"" Italian Sterling Silver Milano Twist Adjustable Chain"	Social Proof
Solar Powered Paw Print Ground Light	Not Dark Pattern
Only 1 left	Scarcity
Candy Melts	Not Dark Pattern
Romantic Ball Gown Tulle Spaghetti Sleeveless Tier Flower Dirl Dress	Not Dark Pattern
Abbie in Calwell, Australia purchased Shark Bite Socks about 1 hour ago	Social Proof
Last purchase was 18 minutes ago by someone from Dublin	Social Proof
7 users have looked at this product in the past 6 minutes	Social Proof
Crystal Shivlingas 	Not Dark Pattern
Facebook icon	Not Dark Pattern
 Midleton Very Rare 	Not Dark Pattern
Pillow & Foam Bed Wedges	Not Dark Pattern
Happiness is to hold flowers in both hands. Furthermore, flowers make for an integral part of all occasions and celebrations........ Read More...	Not Dark Pattern
 Contact Support 	Not Dark Pattern
Only 7 in Stock!	Scarcity
Use the left and right arrow keys to navigate the Menu. Use the enter key to activate the submenu on a navigation item. Use escape key to close the submenu. 	Not Dark Pattern
Score! You've Qualified for a Checkout Bonus	Misdirection
"Someone in Cashmere bought a 
RCM Cosworth Timing Belt Kit 99-02MY EJ20/22/251 hour ago"	Social Proof
No thanks, I don't like FREE stuff.	Misdirection
No thanks, I just want the item	Misdirection
ONLY 1 LEFT IN STOCK	Scarcity
Trending now! Added to basket 38 times today	Social Proof
 Love the way you pay 	Not Dark Pattern
Homeware Trends	Not Dark Pattern
Victoria Victoria Beckham	Not Dark Pattern
In stock, only 1 products left	Scarcity
LAST 1 LEFT	Scarcity
 Rain Boots 	Not Dark Pattern
only 2 left in stock	Scarcity
No thanks, I don't like deals.	Misdirection
Exterior Accessories	Not Dark Pattern
Size low on stock, only 1 item left	Scarcity
Strength & Functional Training	Not Dark Pattern
8 people have this in their bag right now.	Social Proof
Motion Control System	Not Dark Pattern
11 people viewed this today!	Social Proof
View All Home Accents	Not Dark Pattern
SUBSCRIPTION SUCCESSFUL. THANK YOU!	Not Dark Pattern
 Lawn Mowers 	Not Dark Pattern
Sale Clothing	Not Dark Pattern
 Fashion Floral Short Sleeve Dress 	Not Dark Pattern
How about one of these hot sellers?	Misdirection
Only 3 left	Scarcity
Now 20% off, hurry limited time offer!	Urgency
Boys Red School Uniforms	Not Dark Pattern
No thanks, I don't want a free gift.	Misdirection
"Hurry! Sale Ends In:

02:59:50"	Urgency
 info@chainedandable.com 	Not Dark Pattern
NO, I'D RATHER PAY FULL PRICE	Misdirection
activate within 10:00	Urgency
There is only one product left!	Scarcity
00DAYS00HOURS47MINUTES36SECONDS SALE ENDS ONCE COUNTER HITS ZERO	Urgency
SAA Standard Membership - Credit/Debit Card - Automatic Annual Fee	Not Dark Pattern
 Laundry & Cleaning 	Not Dark Pattern
Only 3 left, order soon	Scarcity
 Entertainment Centers & TV Stands 	Not Dark Pattern
No, I don't feel lucky	Misdirection
STAY IN THE LOOP!	Not Dark Pattern
1 left in stock. Hurry!	Scarcity
Blue Raspberry	Not Dark Pattern
Your cart is reserved for 09:35 minutes.	Urgency
LIMITED TIME ONLY: FREE SHIPPING TO SELECT COUNTRIES ON ORDERS OVER $100!	Urgency
ONLY A FEW LEFT!	Scarcity
No thanks, I like full price	Misdirection
HIGH DEMAND	Scarcity
JFN Crew Neck Floral Vacation T-Shirt/Tee	Not Dark Pattern
ONLY A FEW LEFT	Scarcity
 Indoor Festive Lights 	Not Dark Pattern
EastwoodModern, sleek and enchanting, the Eastwood Collection provides comfortable seating while still looking mid-century magnificent.	Not Dark Pattern
 Synthesis Alloy Collection 	Not Dark Pattern
MOST POPULAR	Social Proof
We'd like to send you weekly emails packed full of our lovely products, clearance goodies and cool stuff to win. You can unsubscribe at any time. If you DON'T want to receive these emails, please tick this box. We'd like to send you the occasional brochure so you can get a regular fix of our lovely product! You can unsubscribe at any time. If you DON'T want to receive these brochures, please tick this box. We'd like to introduce you to other brands you might love who will post you the occasional brochure. You can opt out of this at any time. If you DON'T want to receive these brochures, please tick this box.	Misdirection
Occasion: Anniversary	Not Dark Pattern
8 people have viewed this product today!	Social Proof
30 people have purchased this item	Social Proof
Musical Toys	Not Dark Pattern
Chelsea in Burlington, Wisconsin bought Take Out The Boat Jumpsuit, Blackabout 13 minutes ago	Social Proof
Skin Concerns: Treats mild to moderate acne (including whiteheads, blackheads, pimples, and hormonal acne) and excess oiliness.	Not Dark Pattern
Limited Time Offer!	Urgency
Events and Entertainment	Not Dark Pattern
About UsNews & Articles	Not Dark Pattern
Almost gone! Only 3 left In Stock	Scarcity
 Low Maintenance Plants 	Not Dark Pattern
 Men's Apparel Collection 	Not Dark Pattern
 View All Parts 	Not Dark Pattern
We are one of the best online printing technology & solution company successfully serving local and international customers to cherish the joy, love and precious moments in life with various products. Being an instrument to spread your joy and love in a beautiful way we take pride in providing the best quality services. 	Not Dark Pattern
3 people are looking at this product	Social Proof
38 people are viewing this	Social Proof
no thanks, I don't like to save	Misdirection
00 HRS 57 MINS 56 SECS	Urgency
Shop all interactive whiteboards	Not Dark Pattern
Sign up to stay up to date on all White Cloud news and savings!	Not Dark Pattern
Stacey in Saint Marys, United States purchased Extra Long (10 Ft) Fiber Cloth Sync & Charge USB Android Cable - Assorted Colors about 30 minutes ago	Social Proof
Hurry! Only 6 left in stock!	Scarcity
Only 1 Left in this Size!	Scarcity
These pieces are not yet in stock but will be shipped as soon as they are available. The estimated ship date will be noted on the product page.	Not Dark Pattern
Our website implements the ARIA attributes (Accessible Rich Internet Applications) technique, alongside various behavioral changes, to ensure blind users visiting with screen-readers can read, comprehend, and enjoy the website‚Äôs functions. As soon as a user with a screen-reader enters your site, they immediately receive a prompt to enter the Screen-Reader Profile so they can browse and operate your site effectively. Here‚Äôs how our website covers some of the most important screen-reader requirements:	Not Dark Pattern
Only 7 left!	Scarcity
 Yearly 	Not Dark Pattern
 to resolve the issue, or 	Not Dark Pattern
Shop by Activity	Not Dark Pattern
 Home ¬ª 	Not Dark Pattern
Lace Front African American Wigs	Not Dark Pattern
SRX Remotes	Not Dark Pattern
 PAVILION LONG SLEEVE SHIRT DRESS Cornflower Stripe 	Not Dark Pattern
Son in Suisun City, United States purchased Commander Lex	Social Proof
All Brands A-Z 	Not Dark Pattern
Icon MTB Socks - Black/Green	Not Dark Pattern
Focus remotes	Not Dark Pattern
3DAYS124606	Urgency
To cancel your order before it ships, call us.	Obstruction
Signup for email updates from Car and Truck Remotes!	Not Dark Pattern
Easy, awesome! ready to go. Held a charge first night	Not Dark Pattern
More than 752 users are adding shapewear to their cart. Is your size left?	Social Proof
Newborn & InfantYouthAdjustableFlexSnapbacksSale Items- View All -	Not Dark Pattern
Flat Top	Not Dark Pattern
CPUs & Processors	Not Dark Pattern
Brand Directory 	Not Dark Pattern
No, I don't feel lucky.	Misdirection
Only 2 left in stock. Make it yours.	Scarcity
For more information about the VIP Rewards Club Membership, to purchase or terminate a membership, or to start or stop automatic renewal of a membership, contact Ross-Simons Customer Service by postal mail at: Ross-Simons, 9 Ross-Simons Drive, Cranston, Rhode Island 02920; or by email at customerservice@ross-simons.com; or by calling the VIP Rewards Club priority line at 800-835-3799.	Obstruction
 Ôòí 	Not Dark Pattern
Sayeeganesh in Chennai, India just bought Dhoni the Finisher T-Shirt an hour ago	Social Proof
Only 1 left in stock.	Scarcity
 Candy & Snacks 	Not Dark Pattern
Only 1 left , In Stock	Scarcity
65% of our customers added Surefit protection this year.	Social Proof
50% OFF for Limited Time Only!!!	Urgency
 Active Filters English English ‚úò Remove Filter 	Not Dark Pattern
HURRY! ENDS IN: 11 HRS 20 MIN 13 SEC	Urgency
Sabrina in Paraparaumu, New Zealand purchased a SCHO-KA-KOLA Schokakola energy Chocolate caffeine snack food MRE caffeinated 	Social Proof
YOUR CART IS ELIGIBLE FOR AN ADDITIONAL 10% OFF Including Current Promotions + Sale & Clearance 00 hours :29 minutes :26 seconds CHECK OUT NOW	Urgency
 MIN Twins 	Not Dark Pattern
Wedding Cross Stich & Embroidery Patterns	Not Dark Pattern
Choose Type of Cookies You Accept Using	Not Dark Pattern
 ‚òÖ ‚òÖ ‚òÖ ‚òÖ ‚òÖ 	Not Dark Pattern
10 SEATS LEFT	Scarcity
(Only 5 Left)	Scarcity
 Mixed Wine Cases 	Not Dark Pattern
Let's make sure you have everything else you need	Misdirection
80% offers claimed. Hurry up!	Scarcity
WhiteBoho Rose Comforter and Sham Set	Not Dark Pattern
Your order is reserved for 09:57 minutes!	Urgency
 ‚Ç™ ILS 	Not Dark Pattern
 Cooling & Air Treatment 	Not Dark Pattern
Mother‚Äôs Day is undoubtedly a significant occasion for all mothers. But, for the new moms, it is even more special. If you........... Read More...	Not Dark Pattern
LAYAWAY SALE WE WILL MATCH YOUR INITIAL PAYMENT. LIMITED TIME ONLY	Urgency
HURRY! ENDS IN: 10 HRS 40 MIN 00 SEC	Urgency
Mary Janes	Not Dark Pattern
Select Your Year	Not Dark Pattern
What treats can I use?	Not Dark Pattern
We curate the very best in creative and innovative fashion for the EDM Lifestyle. 	Not Dark Pattern
Only 20 left	Scarcity
 Terms of Service 	Not Dark Pattern
Upright Plants	Not Dark Pattern
Your one-time offer! Enjoy 10% off sitewide. Applied at checkout Offer ends in: 04 hrs 37 min 56 sec	Urgency
"""Your purchase entitles you to the following special"""	Misdirection
 Brass Shankh 	Not Dark Pattern
2 people are looking right now	Social Proof
Boys Shorts	Not Dark Pattern
IN HIGH DEMAND!	Scarcity
Low Stock Only 2 left	Scarcity
Anaheim DucksArizona CoyotesCalgary FlamesChicago BlackhawksColorado AvalancheDallas StarsEdmonton OilersLos Angeles KingsMinnesota Wild	Not Dark Pattern
Blankets Throws	Not Dark Pattern
Shop Disposables	Not Dark Pattern
 Free Delivery to Home¬†& Next day delivery available to store* 	Not Dark Pattern
Limited-time Deal	Scarcity
Limited time - Free Shipping on all orders*	Urgency
Surgical & Face Masks	Not Dark Pattern
Hurry! Only 4 left in stock.	Scarcity
No thanks, I despise coupons!	Misdirection
Shop Men's Styles	Not Dark Pattern
If you are one of those constantly devoted to healthy eating, weight loss plans,..	Not Dark Pattern
JULIE in Oak Brook, United States purchased a Watercolor Brush Pens 24 Refillable Colors with Travel Case about 10 hours ago	Social Proof
For a limited time, buy 2 Hydroxycut Hardcore Elite, 30 Servings for $30!	Urgency
(5 Left)	Scarcity
 Choosing the Best Plus Size Briefs 	Not Dark Pattern
FREE SHIPPING FOR A LIMITED TIME | PRICES ARE IN USD AND INCLUDE ALL IMPORT DUTIES.	Urgency
 Cable Winders 	Not Dark Pattern
TSX Remotes	Not Dark Pattern
Only 3 Left In Stock	Scarcity
Baby Bathtubs	Not Dark Pattern
Only 14 left	Scarcity
33 people are eyeing this item!	Social Proof
Nice choice. Did you know you‚Äôre missing out on these deals with the item in your cart. Suit + Shirt + Tie now $599.99* - Shop Suits, Shirts and Ties Or Get 2 Suit Packages for $1100*	Misdirection
No thanks, I don't like saving money	Misdirection
Only 1 Left in Stock. Buy Soon!	Scarcity
19 people have viewed this item	Social Proof
Crossman Air Pistols	Not Dark Pattern
No Thanks, I'd Rather Pay Full Price	Misdirection
Harry Potter 	Not Dark Pattern
FilterSortFeaturedPrice: Low to HighPrice: High to LowAlphabetical: A-ZAlphabetical: Z-A	Not Dark Pattern
We only have 8.0000 left in Stock	Scarcity
Hurry, Sale ends in 9 Hours!	Urgency
Jewelry Care Kit	Not Dark Pattern
Give a Gift	Not Dark Pattern
 First name * 	Not Dark Pattern
166 people have added this item to cart	Social Proof
LIMITED TIME LEFT! 00 : 46 : 11	Urgency
Speak with our customer-care executive who will help you with your buying.	Not Dark Pattern
Mechanic's Wear	Not Dark Pattern
Please note: we do not ship to PO Boxes	Not Dark Pattern
Michael M. from Lacey, WA just bought a Cal King	Social Proof
Products are automatically delivered on your schedule. No obligation, modify or cancel your subscription anytime. 	Not Dark Pattern
There are only 1 item left in stock.	Scarcity
Free Shipping*	Not Dark Pattern
Crystals are alive. Born inside Mother Earth, crystal energy can be felt just like heat or cold. For chakra training to astrological remedies, discover healing crystals.	Not Dark Pattern
A-Z Luxury Brands	Not Dark Pattern
ALMOST GONE - only 2 remaining!	Scarcity
Offer ends in 03 days 19 hours : 54 mins : 22 secs	Urgency
Over 200 views in 24 hrs	Social Proof
Hurry, only 302 left.	Scarcity
Shotgun Bore Mops	Not Dark Pattern
POPULAR 64 others checked this out in the last few hours.	Social Proof
ONLY 5 LEFT IN STOCK	Scarcity
No thanks, I hate saving money	Misdirection
Moroccan Rugs	Not Dark Pattern
ONLY AVAILABLE FOR A LIMITED TIME	Urgency
 Sprouting 	Not Dark Pattern
Help us #savethefishies.	Not Dark Pattern
5 items left	Scarcity
This product was viewed 26 seconds ago by someone from Princeton	Social Proof
ONLY 1 ITEM LEFT!	Scarcity
ONLY 11 LEFT	Scarcity
Only a few left of this product!	Scarcity
JFN Scallop V Neck Solid Casual T-Shirt/Tee	Not Dark Pattern
Purchased 6 times this week.	Social Proof
Crochet Baby Patterns	Not Dark Pattern
Felizer Designer Diamond studded Round Dial Metal starp watch for Women & Girls - Silver (Heart design) Analog	Not Dark Pattern
 Home / Black Tapered Belted Cigarette Trousers - Myasia 	Not Dark Pattern
Only 4 left at this price	Scarcity
Once a celebrated author of short stories now in his twilight years, 	Not Dark Pattern
Recent Searches	Not Dark Pattern
 Brand case & cloth included 	Not Dark Pattern
Hair Color + Highlights	Not Dark Pattern
We combined powerful, yet gentle acne-fighting ingredients with our own unique plant-based complexes to help reduce irritation and redness associated with acne and breakouts. The result? Skin that‚Äôs nourished, smooth, and most importantly, clear!	Not Dark Pattern
Only 2 left, order soon	Scarcity
 Food 	Not Dark Pattern
MORE WAYS TO SHOP	Not Dark Pattern
Your shopping cart is empty.	Not Dark Pattern
Coin Necklace 	Not Dark Pattern
Mallet E Speed Lace - Black/Silver	Not Dark Pattern
Someone from Huntingtown, Maryland, United States purchased TopCoat¬Æ F11¬Æ Polish & Sealer - Web Special Kits Just Now	Social Proof
You may cancel your VIP membership at any time by calling 1-866-337-0906 (open 24/7).	Obstruction
Items in your cart are in VERY high-demand.	Scarcity
Sign up to our mailing list here and be the first to know about exclusive offers and events	Not Dark Pattern
Items in your cart are selling fast	Scarcity
No thanks, I don't like winning.	Misdirection
Laundry Care	Not Dark Pattern
Low in stock: only 2 left.	Scarcity
Deal Ends In 2 : DAYS13 : HRS10 : MIN24 SEC	Urgency
Order soon, only 1 left!	Scarcity
This campaign was taken down for content reasons	Not Dark Pattern
Hurry, only 2 left in stock!	Scarcity
AdjustableSnapbacksSale Items- View All -	Not Dark Pattern
ONLY 5 LEFT IN STOCK!	Scarcity
Over 238 people have bought this product	Social Proof
Order in 13:16 to get $200 off your mattress	Urgency
 Bob Ross Oil Brushes 	Not Dark Pattern
No Thanks, I'd rather pay full price	Misdirection
Terra - Medium Brown	Not Dark Pattern
Warning: Last items in stock!	Scarcity
Work With More Buyers And Sellers?	Not Dark Pattern
 Lighting	Not Dark Pattern
 Round Neck Casual Loose Patchwork Printed Short Sleeve Blouse 	Not Dark Pattern
39 recently purchased it	Social Proof
Limited Time Offer: 10% Off your first order!	Urgency
Computer Accessories	Not Dark Pattern
Aromatherapy¬†	Not Dark Pattern
A Ritual of Light	Not Dark Pattern
Hurry only 2 left	Scarcity
21 people looked at this during the last 24 hours	Social Proof
Black Jeans	Not Dark Pattern
Build your own powerful multi-vendor marketplace website	Not Dark Pattern
Items in your cart are in high demand, but we have reserved your order.	Scarcity
167 piece(s) left for this promo	Scarcity
No Thanks, I don't like free stuff.	Misdirection
Only 32 left in stock	Scarcity
Less than 10 left!	Scarcity
CUSTOMER SERVICE	Not Dark Pattern
Hurry! Sale ends in:	Urgency
NRA Firearms For Freedom	Not Dark Pattern
Low in stock	Scarcity
Availability: Only 1 Left	Scarcity
 Printed Long Sleeves Casual Blouse For Women 	Not Dark Pattern
Straight Hair Extensions	Not Dark Pattern
Radio and GPS Pouches	Not Dark Pattern
Only 3 left!	Scarcity
Only 4 unit(s) available!	Scarcity
Anniversary Gifts by Year	Not Dark Pattern
All Scrapbooking Supplies	Not Dark Pattern
No USB or Y-Adapter!? Our USB Sound Card is highly recommended for PC (Mac/Linux/Windows) and works with current gen consoles. The Y adapter is recommended for console gaming, phone, or other TRRS jacks.	Misdirection
 New In	Not Dark Pattern
146 people recently purchased this.	Social Proof
Only 25 Deals left	Scarcity
HOW TO MANAGE SIDE EFFECTS	Not Dark Pattern
Website Accessibility	Not Dark Pattern
 Item added to cart. View cart and check out. Close 	Not Dark Pattern
Heat Mats & Strips	Not Dark Pattern
HURRY! YOUR 10% OFF EXPIRES IN 29:43	Urgency
3 people bought this item last week.	Social Proof
 Share on Pinterest 	Not Dark Pattern
Only 8 left in stock	Scarcity
Hurry! This special sale ends in 2h 42m 0s	Urgency
Hype. Home	Not Dark Pattern
VIP OFFERS END 00:54:59	Urgency
Roommates agreement... need i say more? this is a great poster for the walls of any house that has more than one person living in it. if you're alone, get it all the same - it'll make you laugh at any given time :)	Not Dark Pattern
This is how you can reject or delete your cookies	Not Dark Pattern
Ericdress Round Neck Three-Quarter Sleeve Mid-Calf Pullover Fall Women's Dress	Not Dark Pattern
 Email Address 	Not Dark Pattern
Your cart is reserved for 14:57 minutes!	Urgency
No thanks, I don't want any deals	Misdirection
Toddler Boy Underwear and Undershirts	Not Dark Pattern
Collegiate Shooting Programs	Not Dark Pattern
ONLY 1 ITEM LEFT	Scarcity
01 Hours 37 Minutes 48 Seconds 1/10s	Urgency
 Supporting All Artists Create because you can 	Not Dark Pattern
HomeFlowersColourful Mixed Roses Bouquet	Not Dark Pattern
Send as giftexpand_more	Not Dark Pattern
Delivery & Returns	Not Dark Pattern
Only: 9 in stock now	Scarcity
Only 3 left , In Stock	Scarcity
Livefood Subscription	Not Dark Pattern
Grocery & Liquor	Not Dark Pattern
 For Wife 	Not Dark Pattern
UP TO 60% OFF SPRING SALE PLUS 10% OFF ALL SHOWERS ENTER CODE SHOWERS10 AT CHECKOUT, MUST END TUESDAY 02DAYS  :  04HOURS  :  13MINS  :  28SECS	Urgency
Great for keeping track of your pup while at work	Not Dark Pattern
 Subscribe 	Not Dark Pattern
Powered by	Not Dark Pattern
JerseysPantsSleepwear & UnderwearSwim CollectionT-ShirtsSale Items- View All -	Not Dark Pattern
Hurry, Only a few left!	Scarcity
 I love this phone case! üòç #phonecase #hiraeth #appleiphone #apple #rosegold #loveit 	Not Dark Pattern
ONLY 1 LEFT IN THIS SIZE	Scarcity
Looking for your order history?	Not Dark Pattern
Only 82 left in stock!	Scarcity
Readers looking for some old-fashioned storytelling with a sprinkling of magic will find it here. 	Not Dark Pattern
Traditional Snacks	Not Dark Pattern
 Travel Accessories 	Not Dark Pattern
eWriters & Graphics Tablets	Not Dark Pattern
 EU Delivery & Returns 	Not Dark Pattern
LIMITED TIME OFFER MEN'S CHINOS & 5-POCKET PANTS BUY 2 FOR $59.90 EACH SHOP NOW	Urgency
Your order will be reserved for 6:56 minutes.	Urgency
LESS THAN 8 LEFT IN STOCK!	Scarcity
 United States 	Not Dark Pattern
Limited Time Sale - Buy Now!	Urgency
 Mobile Terms of Use 	Not Dark Pattern
 ALL SALE 	Not Dark Pattern
MyStore	Not Dark Pattern
JUST 1 LEFT!	Scarcity
Don't snooze, only 1 left	Scarcity
I agree to receive marketing emails from Natural Life and agree to our Privacy Policy and terms of use.	Forced Action
Don't miss out, only 2 left in stock	Scarcity
Someone from Rochedale, Queensland, Australia started buying this!	Social Proof
 Please click 	Not Dark Pattern
 Box Springs & Foundations	Not Dark Pattern
Countdown	Not Dark Pattern
Men's Pullover Sweaters	Not Dark Pattern
 Tony Bianco 	Not Dark Pattern
 LOGO BLACK 	Not Dark Pattern
Everything was perfect. The delivery was very smooth and the products were in great condition as well.	Not Dark Pattern
 Face Masks	Not Dark Pattern
LIMITED TIME OFFER!	Urgency
Low In Stock Today	Scarcity
Lenscap: Damage Only	Misdirection
With 1-year Care Subscription 10 days history	Misdirection
About Ruth Hogan	Not Dark Pattern
Don't miss out on this item! There is only 1 left in stock.	Scarcity
NO, THANKS. I DON'T LIKE DISCOUNTS 	Misdirection
No thanks, I'd rather pay full price.	Misdirection
Wait! Take 10% off Your First Order Deal Expires Soon!	Urgency
Diamond Nose Studs	Not Dark Pattern
Perhaps you could...	Not Dark Pattern
CANCELLATION POLICY: If you are not completely satisfied with Yogi Surprise, you can cancel your membership and discontinue your monthly payments at any time. In order to cancel before you are renewed for the next shipment, you need to contact Yogi Surprise prior to the renewal date on the 14th of each month. Email: support@yogisurprise.com and we‚Äôll respond promptly. If your membership has already renewed and you‚Äôd like to cancel an upcoming shipment, you must request cancellation by the 3rd of the month to be eligible for a refund. IF YOU DO NOT CANCEL PRIOR TO THE THIRD DAY OF A CALENDAR MONTH, YOU CANNOT BE REFUNDED FOR THAT MONTH‚ÄôS SHIPMENT. WE DO NOT OFFER REFUNDS ON BOXES THAT HAVE ALREADY BEEN SHIPPED. To request cancellation, simply click here and submit the contact form or email us: support@yogisurprise.com. We‚Äôll get back to promptly!	Obstruction
Limited Time Only! 20% Off	Urgency
Hurry, only 2 left in stock	Scarcity
 Casual V-Neck Sleeveless T-Shirt 	Not Dark Pattern
 Businesses in the EU buying from a business in the same country are also charged VAT.	Not Dark Pattern
Someone in Flemington, United States purchased Anti-Aging Eyelid Tape (Contains 100 Strips) Just now	Social Proof
Hurry only 8 items left!	Scarcity
 Shop 	Not Dark Pattern
Someone in United States just purchased a	Social Proof
LIMITED TIME: $10 OFF! DISCOUNT REFLECTED IN PRICE!	Urgency
 Rechargeable 	Not Dark Pattern
 Redeem Gift Certificates 	Not Dark Pattern
Hurry! 1 items left!	Scarcity
Muc-Off	Not Dark Pattern
Frequently Asked Questions	Not Dark Pattern
We value your input. Share your review so everyone else can enjoy it too.	Not Dark Pattern
Someone in Byron Bay, NSW just bought	Social Proof
Last 1 left	Scarcity
Limited quantity available	Scarcity
 ‡•ê Welcome to Devshoppe Sign In or Create an Account 	Not Dark Pattern
Code of Conduct	Not Dark Pattern
Macro Focussing Rails	Not Dark Pattern
Tactical Rifles	Not Dark Pattern
Bottoms Deals	Not Dark Pattern
Checkout within 04:10 so we don't run out of stock!	Urgency
3,081 people have viewed this item	Social Proof
 Champagne Taittinger 	Not Dark Pattern
Hurry! Only 7 left	Scarcity
19,302 people have added this item to cart	Social Proof
We will also send you an additional email confirming your renewal. Should you elect not to renew your Membership, you may cancel at any time prior to the renewal by emailing us at passportmembership@1800flowers.com and your credit/debit card on file with us will not be charged. A confirmation email will be sent to you. If you email to cancel after your Membership has been renewed, your credit/debit card will have been charged the then current paid annual membership fee for the Passport Program, however you may request, and 1-800-Flowers may grant, a pro-rata refund within its sole discretion based upon the extent that you may have utilized the benefits of the Passport Program and the period of time remaining on your paid Membership.	Obstruction
Howdy stranger, looks like your trail has hit a dead end.	Not Dark Pattern
 Maker Faire News 	Not Dark Pattern
31 people seeing this product right now	Social Proof
3 other people are currently viewing this item.	Social Proof
Favored By: 400 people!	Social Proof
 All Shoes 	Not Dark Pattern
 What's New New arrivals daily 	Not Dark Pattern
143 BOUGHT	Social Proof
WARNING! Only 5 left in stock!	Scarcity
No thanks, I've got too much cool Glock stuff!	Misdirection
43 added to bag in the last 48hrs	Social Proof
67% offers claimed. Hurry up!	Scarcity
Party & Birthday Novelties	Not Dark Pattern
 Temple Locks 	Not Dark Pattern
Sara from Philadelphia just saved $68 on her order.	Social Proof
17 people have viewed this wine today	Social Proof
 Data Processor: Amobee 	Not Dark Pattern
new merch coming soon	Not Dark Pattern
Prices subject to change without notice. Products shown may not be available in our stores.	Not Dark Pattern
Add your favourites to cart	Not Dark Pattern
Free Shipping On Orders Over $49* - Limited Time Only	Urgency
Someone in DOVER, United States just bought Crew 15 mins ago	Social Proof
 Payment Methods 	Not Dark Pattern
 Also notify me about New Arrivals! 	Not Dark Pattern
POSTED BY @missladywoolf#motoin	Not Dark Pattern
 All Personalised Gifts 	Not Dark Pattern
HURRY! ONLY 19 LEFT IN STOCK.	Scarcity
Massive Tax Time Sale See Discounts! Sale ends in	Urgency
Special sale ends in	Urgency
By clicking ‚ÄúAccept All Cookies‚Äù, you agree to the storing of cookies on your device to enhance site navigation, analyze site usage, and assist in our marketing efforts. 	Not Dark Pattern
Sorry! This product is no longer available	Not Dark Pattern
Brand: Ray-Ban¬Æ | Similar products from Ray-Ban¬Æ	Not Dark Pattern
No thanks, free stuff isn't for me.	Misdirection
Only 2 Left	Scarcity
 Colored Contact Lenses 	Not Dark Pattern
Isra√´l in Metz, France purchased a More ADVANCED Chord Substitutions	Social Proof
In stock | 44 left	Scarcity
only 7 pieces left	Scarcity
Download Now	Not Dark Pattern
Beach Towels & Mats	Not Dark Pattern
ENDS IN - Flash Offer - TWO PAIRS OF SHOES FOR $319 PROMO CODE AUTO-APPLIED AT CHECKOUT! 0 Days : 16 Hours : 09 Minutes : 57 Seconds	Urgency
Hurry, limited quantities left!	Scarcity
Light Works	Not Dark Pattern
Both of these jerseys are awesome, I couldn‚Äôt have asked for better quality.	Not Dark Pattern
Only 14 left!	Scarcity
NO THANKS, I DON'T WANT 20% OFF MY ORDER	Misdirection
I already have this item. Do not add this to cart	Misdirection
Security Cameras	Not Dark Pattern
Cross Body	Not Dark Pattern
 -- Preeti Shenoy, author of THE RULE BREAKERS	Not Dark Pattern
Royal Python Vivariums	Not Dark Pattern
Stone Island Junior	Not Dark Pattern
ONLY 1 LEFT!	Scarcity
 Sustainably made	Not Dark Pattern
Bob's For Business	Not Dark Pattern
"""We'd love to send you emails with offers and new products from New Balance Athletics, Inc. but if you do not wish to receive these updates, please tick this box."	Misdirection
Boys Green School Uniforms	Not Dark Pattern
 Show Password 	Not Dark Pattern
Pay Securely with Trespass	Not Dark Pattern
Limited Stock!	Scarcity
 adidas Originals Stan Smith 	Not Dark Pattern
LIMITED TIME - BUY THE NEW PURPLE PLUSH PILLOW, GET ONE FREE	Urgency
 Functional Marketing Cookies	Not Dark Pattern
Limited Time Offers	Urgency
Someone in Bacchus Marsh bought a Noosa Basics Deodorant Stick - Sensitive (60g) 27 seconds ago	Social Proof
436 users are currently active on our website Just now	Social Proof
Exposed Membership (recurring subscription) and Cancellations  If You order with Exposed Membership, you are selecting a recurring billing subscription, where You will receive a new kit approximately every 60 days. You are able to cancel by contacting Exposed customer care at 1-866-404-7656, 8am ‚Äì 4pm Pacific Time, M-F.  If You are part of our Monthly installment program, You will be billed in two monthly installments for each acne kit shipped. Each kit will be shipped every two months unless your membership is canceled. To cancel Your Exposed Membership, You must: 1. first pay in full for all kits that have been shipped 2. and, then contact Exposed customer care at 1-866-404-7656 8am ‚Äì 4pm Pacific Time, M-F to process Your cancellation.	Obstruction
Sale Coats and Jackets	Not Dark Pattern
Shop By Brands	Not Dark Pattern
Did you know that Shaver heads need replacing every 12 - 18 months? Get the Shaver Guard cleaning spray to extend its life for up to another 6 months!	Misdirection
ROAD CLOTHING	Not Dark Pattern
No thanks, I don't want to build one.. I'd rather kick rocks!	Misdirection
 Menstrual Products 	Not Dark Pattern
4 SEATS LEFT	Scarcity
Someone in Keilor East bought a Piranta-Edge Skinning Knife - Blaze - Havalon Knives54 minutes ago	Social Proof
Shoes & Clothing	Not Dark Pattern
Imported	Not Dark Pattern
Will sell out fast!	Scarcity
Get it fast! 14 added to bag today	Social Proof
Herbaceous oil rich in anti-aging polyphenols.	Not Dark Pattern
HURRY! LESS THAN 129 LEFT.	Scarcity
Ken in Three Bridges, United States purchased All Zebrawood + Olive Ash	Social Proof
Only 3 left in stock	Scarcity
We only have 5 left!	Scarcity
Nah, I like paying full price	Misdirection
2 people have looked at this in the last couple of hrs.	Social Proof
Real time 30 Visitor right now	Social Proof
Drawstring Backpacks	Not Dark Pattern
Please note all products are made in limited quantities and we rarely restock - checkout now so you don't miss out!	Scarcity
No thanks, I don't like getting free stuff.	Misdirection
THIS PRODUCT HAS BEEN VIEWED 480 TIMES IN THE LAST 48 HOURS	Social Proof
HURRY! ONLY 2 LEFT!	Scarcity
Less than 7 left!	Scarcity
BOTTLES LEFT 3	Scarcity
Items reserved for 15:00	Urgency
ONLY 4 LEFT!	Scarcity
-90% discount if you order within 9:55:44	Urgency
 Latest looks from Myleene Klass Shop now 	Not Dark Pattern
Only 9 left in stock	Scarcity
ADD FOR BETTER RESULTS	Misdirection
 Affiliate 	Not Dark Pattern
Auto Delivery Program	Not Dark Pattern
Save $148.98AUD ‚Äì 49% Off	Misdirection
Low Stock ‚Äì Selling Fast	Scarcity
2 PEOPLE HAVE ADDED THIS ITEM TO THEIR CART TODAY	Social Proof
Only 6 left	Scarcity
Pro Boost Treatments	Not Dark Pattern
Baby Nursing & Feeding	Not Dark Pattern
4 bought in the last 24 hours.	Social Proof
We're offline	Not Dark Pattern
12 customers viewed this product today!	Social Proof
 Gemstone softwares 	Not Dark Pattern
Graphic Tanks	Not Dark Pattern
LOW STOCK (ONLY 10 LEFT!)	Scarcity
JOHN in Toowoomba City, Australia purchased a Resin Tank 7 hours ago	Social Proof
 V-neck Printed Loose Short-sleeved T-shirt 	Not Dark Pattern
Limited Time Only ¬∑ Online Only	Urgency
 Teething Remedies 	Not Dark Pattern
Partnerships	Not Dark Pattern
Accord remotes	Not Dark Pattern
72 Viewing This Product	Social Proof
Something went wrong. Please try again	Not Dark Pattern
 Coloured Pencils 	Not Dark Pattern
Only 1 left in stock!	Scarcity
Only 9 units left in stock online.	Scarcity
Feeding Nightwear	Not Dark Pattern
 Gift Card FAQs 	Not Dark Pattern
Someone in Canberra purchased\nADV.2 (Austracantha) about 41 minutes ago	Social Proof
Ducted Vacuum Cleaners	Not Dark Pattern
Work Solid Simple Crew Neck Half Sleeve Top	Not Dark Pattern
No thank you, I prefer to pay for shipping.	Misdirection
White Plus Size Clothing	Not Dark Pattern
No thanks, I don't like exclusive offers	Misdirection
273 units sold in the last 30 days	Social Proof
No thanks, I'll just pay full price.	Misdirection
No, I'd rather do it the hard way...	Misdirection
User interface customization persistent cookies are used to store a user‚Äôs preference regarding a service. Please note that these cookies are exempt from consent.	Not Dark Pattern
After getting my jersey on Monday, I am hooked on CoolHockey. I will surely be buying from CoolHockey from now on.	Not Dark Pattern
Congratulations! You qualify to receive Rechargeable 10-Function Bullet Vibe for FREE!	Misdirection
Other 2 customers have it in their cart.	Social Proof
Elegant A Line Chiffon V-neck Long Sleeve Bridesmaid Dress with Pleats and Ruching	Not Dark Pattern
White Camo Windbreaker - Rock N' Roll	Not Dark Pattern
xB Remotes	Not Dark Pattern
 Football Boots 	Not Dark Pattern
Selling fast! Add to bag 7 times in the last 48 hours.	Social Proof
Only 2 items left	Scarcity
Marc in Newton, United States purchasedKTM Stand Plate Large KTM...	Social Proof
Sandeep in Hawthorne, California bought Sadie Ponte Pants - Black Just Now	Social Proof
Lifestyle / Music	Not Dark Pattern
Only 1 unit left in stock	Scarcity
LOW IN STOCK!! GET YOURS NOW	Scarcity
Laurie in Urraween, Queensland bought No Brainer USB Charging Anti-Theft Backpack	Social Proof
High Arches	Not Dark Pattern
Contract free	Not Dark Pattern
Someone in Cedarhurst, United States purchased a Sproet and Sprout Shell/Violet Stripe Bloomers	Social Proof
Your order is prioritized for 13:22 minutes!	Urgency
How Do I Rinse Off My Overnight Hair Oil Treatment?	Not Dark Pattern
Black Jewelry	Not Dark Pattern
Cart will expire in 08:19 minutes!	Urgency
Time remaining: 04:50	Urgency
0:44:56	Urgency
 Watches & Accessories 	Not Dark Pattern
No thanks, I don't like free stuff	Misdirection
DAYS HRS MINS SECS	Urgency
"Here for a limited time. 4.5"" Red Bottle Sticker w/ Adam's Logo"	Urgency
Limited time offer.	Urgency
3 left	Scarcity
Someone in Faizabad just bought: Pretty Love Penis Sleeve 7 inch an hour 2 minutes ago	Social Proof
Limited Time Remaining!	Urgency
I WANT TO PAY MORE LATER ;)	Misdirection
Limited Time Only - Up to 30% OFF Freshwater Plants! SHOP NOW >	Urgency
Back by Demand	Not Dark Pattern
ONLY 5 LEFT, HURRY!	Scarcity
Functional Cookies	Not Dark Pattern
Flash Sale ends in SHOP NOW  	Urgency
 Born for adventures across land, desert, and ice. Cruise over Tarmac-free roads or adapt it to be your 'do anything' commuter. 	Not Dark Pattern
Performance Cookies	Not Dark Pattern
I am very pleased with the service I received.	Not Dark Pattern
7 customers have this in their basket	Social Proof
Jacob in Seymour, Wisconsin, United States purchased a Bass XL just now!	Social Proof
Hurry! Only 9 left in stock.	Scarcity
 shop by trend 	Not Dark Pattern
13:09:27 HOURS MINUTES SECONDS Sale Ends Once The Timer Hits Zero!	Urgency
Delivery & support	Not Dark Pattern
SHOP TRIATHLON	Not Dark Pattern
The product you requested is not available in the selected country	Not Dark Pattern
No thanks, I don't like winning	Misdirection
You choose: just one box, or a  Madison Reed Membership?	Misdirection
Baby Cross Stitch & Embroidery Patterns	Not Dark Pattern
HHR remotes	Not Dark Pattern
No, I Don't Like Discounts	Misdirection
LIMITED TIME BLOW OUT SALE UP TO 70% OFF! 110% BEST PRICE GUARANTEE!	Urgency
$69.50 For A Limited Time Details	Urgency
 Accessibility statement 	Not Dark Pattern
Hurry! Only 1 Left In Stock	Scarcity
2,221 people have purchased this item	Social Proof
No, thanks. I'd prefer not to save.	Misdirection
SAVE $200 OFF PUFFY	Urgency
 Data Processor Privacy Policy: https://triplelift.com/privacy 	Not Dark Pattern
Tambria in Hattiesburg just bought Peruvian Virgin Natural Wave Hair 3 Bundles with Lace Frontal, 100% Human Virgin Hair 	Social Proof
1 item left	Scarcity
Order without free membership $69.95	Misdirection
 This product can expose you to chemicals including Hexavalent which is known to the State of California to cause cancer on birth defects or other reproductive harm. For more information, visit 	Not Dark Pattern
Someone in Vancouver, Washington purchased a Orthofeet Men's Orthotic Insoles about 38 minutes	Social Proof
Only 5 left!	Scarcity
 Brushes 	Not Dark Pattern
Rose in Portland, United States purchased Green Eco-Friendly iPhone XR Case about 54 minutes ago	Social Proof
 Data Processor Privacy Policy: https://casalemedia.com/ 	Not Dark Pattern
No thanks, I'll still want to pay full price	Misdirection
Only 3 Left in Stock!	Scarcity
Limited time - final price reflects extra 29% off	Urgency
Hurry! Only 6 left in stock.	Scarcity
 We value your privacy We use cookies to improve your website experience. We also use third-party cookies for marketing purposes. Learn more. 	Not Dark Pattern
 Unstitched Fabric 	Not Dark Pattern
 Polar Lights II 	Not Dark Pattern
Shop by Health Goals	Not Dark Pattern
No thanks, I'm not interested	Misdirection
Customer also shopped for	Misdirection
Shop Safely And Securely	Not Dark Pattern
 powered by: Cookie Information 	Not Dark Pattern
Free Shipping & Easy Returns always! 	Not Dark Pattern
Combination	Not Dark Pattern
No Thanks, I Don't Want To Save	Misdirection
QUANTITY: *ONLY 1 LEFT	Scarcity
6 customers have this in their basket	Social Proof
GCC Compliance	Not Dark Pattern
 Please try again 	Not Dark Pattern
How Do Our Crystals Looks in Real Life?	Not Dark Pattern
No thanks, I want to pay full price	Misdirection
commonpandacom@commonpandacom	Not Dark Pattern
Yes, I Want To Save Money!No Thanks	Misdirection
OFFER ENDS IN: 00:32:04 TIME IS RUNNING OUT!	Urgency
ONLY $1.99 FOR YOUR FIRST SIX MONTHS, THEN EACH YEAR YOUR MEMBERSHIP WILL AUTOMATICALLY RENEW FOR $39.99 AND BE CHARGED TO YOUR CREDIT/DEBIT CARD ON FILE. CANCEL YOUR VIP MEMBERSHIP ANY TIME TO RECEIVE A PRORATED REFUND BY CALLING (800) 543-7309. BY SUBMITTING YOUR ORDER, YOU AGREE TO THESE VIP MEMBERSHIP TERMS.	Obstruction
Only 4 left in this size!	Scarcity
You might also like	Not Dark Pattern
Shop By Fabric	Not Dark Pattern
Chirag in Anoopshahr just got the JAYS - a-JAYS One+ about 17 minutes ago	Social Proof
 View all Ink categories 	Not Dark Pattern
 Intercoastal Performance Pant - True Navy 	Not Dark Pattern
NO THANKS, I DON‚ÄôT WANT 15% OFF	Misdirection
Bike Parts & Components	Not Dark Pattern
üî•üëÅÔ∏è 1 person is viewing this.	Social Proof
Estimated VAT overview	Not Dark Pattern
 Your company account is blocked and you cannot place orders. If you have questions, please contact your company administrator. 	Not Dark Pattern
Hand & Foot Skin Care	Not Dark Pattern
 Best Deals of the Month: April Edition 	Not Dark Pattern
Hurry up! Only 4 left in stock	Scarcity
Accent Chairs	Not Dark Pattern
No thanks, I don't like to save	Misdirection
 Subscribe To Us Subscribe 	Not Dark Pattern
Customers also bought	Misdirection
407 customers have viewed this item recently	Social Proof
Only 1 item(s) left in stock	Scarcity
 Kyanite Beads 	Not Dark Pattern
No, I don't want great deals.	Misdirection
I have a strong liking to walnut. Even the sapwood can look very presentable when finished good. Thus cutting board is a great item for use and conversation and looks good. 	Not Dark Pattern
Holland Cooper	Not Dark Pattern
Recovery Best Sellers	Not Dark Pattern
Viewed 1040 times in the last 7 days	Social Proof
U.S. Vape Mail Ban FAQs	Not Dark Pattern
Áï∞Ê•≠Âêà‰Ωú Cooperation	Not Dark Pattern
6 people have looked at this in the last few hrs.	Social Proof
Limited-time Offer: Bundle a base and get 20% off	Misdirection
Sale Womens Clothing	Not Dark Pattern
Why I chose this:	Not Dark Pattern
TWO FREE PILLOWS AND 30% OFF WITH PROMO CODE	Misdirection
View Alternatives	Not Dark Pattern
11 11 Hours: 00 22 Minutes: 3223 3223 Seconds Sale Ends Once The Timer Hits Zero!	Urgency
Security is our top priority. Our subscription payments are powered by Stripe and ReCharge, processed in a secure PCI-compliant environment to the highest industry standards. Ketolent staff never know your credit card number.	Not Dark Pattern
Jim in Houston, USA purchased Pure Ratios: Hemp Oil CBD Patch (40mg CBD)	Social Proof
Only 22 left in stock!	Scarcity
ADD WORLD'S MOST COMFORTABLE CHAIRS	Misdirection
ONLY 3 LEFT IN STOCK!	Scarcity
Watch how its done	Not Dark Pattern
 View all Oil & Acrylic Brushes categories 	Not Dark Pattern
Get Personalised Health PlanGet Health Plan	Not Dark Pattern
Someone in Louisville Kentucky United States Purchased Gold Presidential Bracelet With Watch Buckle 9 hours ago	Social Proof
LESS THAN 5 LEFT!	Scarcity
[new-troh-pick]	Not Dark Pattern
ADHD Friendly Profile: this profile significantly reduces distractions and noise to help people with ADHD, and Neurodevelopmental disorders browse, read, and focus on the essential elements more easily.	Not Dark Pattern
Long and Tall	Not Dark Pattern
This offer is only VALID if you add to cart now!	Misdirection
Sign up for the latest updates, products and offers	Not Dark Pattern
Subscribing means you agree to receive our emails, more details please refer to ourprivacy policy.	Not Dark Pattern
 Shop Sale by Print 	Not Dark Pattern
Flash Sale Alert! You can now buy Utorch Corridor Porch Aisle Lights from Gearbest.com for only $7.99 (47% off). Hurry up, limited time offer!	Urgency
Only 9 left	Scarcity
Our items sell fast, don't miss out!	Scarcity
Your order has been reserved for	Urgency
Sale ends soon	Urgency
only 5 left in stock	Scarcity
135 people have this in their cart	Social Proof
The Hoop Destination. Discover more	Not Dark Pattern
Tight Bud	Not Dark Pattern
6 other people looking at this item	Social Proof
selected languageÊó•Êú¨Ë™ûcurrencyJPY	Not Dark Pattern
Great choice!	Not Dark Pattern
Only 1 items left	Scarcity
Would you like to purchase an Extended Protection Plan?	Misdirection
ONLY 14 LEFT AT THIS PRICE	Scarcity
Not sold separately	Not Dark Pattern
16 recently purchased it.	Social Proof
Plus Size Ripped Jeans	Not Dark Pattern
 Redirecting to Futech Deals for secure checkout... 	Not Dark Pattern
Football	Not Dark Pattern
 All Men's Brands 	Not Dark Pattern
*Freight/Higher Freight charges may apply to some areas. Click here to view Shipping Policy	Not Dark Pattern
Long Sleeves Nightwear	Not Dark Pattern
Faith in Glendale, United States purchased a Choose Your Flavors 5 Bag Sample Pack (Whole Bean) about 1 hour ago	Social Proof
 Hairy Chest T-Shirt And Shorts Combo 	Not Dark Pattern
Covered all grays	Not Dark Pattern
7 sold in the last 48 hours	Social Proof
 Menthol Flavors 	Not Dark Pattern
Someone in Alexandria, United States just bought TTDeye Queen Green Colored Contact Lenses	Social Proof
FLASH 19:15:22	Urgency
Only available for a LIMITED TIME, so get yours TODAY!	Urgency
2 in stock	Scarcity
Oxfords & Loafers	Not Dark Pattern
Only 9 items left!	Scarcity
Reloading & Ammunition	Not Dark Pattern
Someone purchased a FORWARD REVIVE WOMEN'S RED WHITE HUSTLE T-SHIRT 32 minutes ago	Social Proof
Joe M from , Bought a Cartoon Caterpillar Rigged 3D Model Recently	Social Proof
Annie in Cheras, Malaysia just bought: An Abundance of Flowers - Van-Go Paint-By-Number Kit	Social Proof
Read More 	Not Dark Pattern
Ketolent subscriptions have no long term contracts. Pause, cancel, or change at any time. Want to swap Vanilla for Chocolate, or set up to renew every 3 weeks? No problem! Send us an email to help@ketolent.com and we'll make the change for you.	Obstruction
Selling Fast	Scarcity
NO THANKS, I'D RATHER PAY FULL PRICE	Misdirection
 Stone Cold Steve Austin 	Not Dark Pattern
92 customers bought this in the last 48 hours	Social Proof
An item you ordered is in high demand. No worries, we have reserved your order.	Scarcity
Click and Collect T&C	Not Dark Pattern
Someone added 1pc 4ocean natural stone beads beaded bracelet men boho handmade to their cart RIGHT NOW	Social Proof
LIMITED TIME ONLY 10 OFF 50 SPEND NEW CUSTOMERS ONLY - TERMS & CONDITIONS APPLY	Urgency
Shirts & Blouses	Not Dark Pattern
Different Types of Gold	Not Dark Pattern
HURRY! ONLY 14 LEFT IN STOCK.	Scarcity
The best!	Not Dark Pattern
HURRY, THERE ARE ONLY 9 ITEM(S) LEFT!	Scarcity
 Tracksuit	Not Dark Pattern
Trending Style! Sold 4 times today	Social Proof
Long African American Wigs	Not Dark Pattern
Only one left in stock - order soon!	Scarcity
Hurry, only 1 left in stock!	Scarcity
Trending now! Added to basket 490 times today	Social Proof
Almost Famous Jeans	Not Dark Pattern
No Thanks, I Don't Like Saving Money.	Misdirection
Professional Color Tool Kit / Addons	Misdirection
 Tweet Share Pin It Add Email 	Not Dark Pattern
 Tights 	Not Dark Pattern
Only 5 left	Scarcity
Wireless Microphone	Not Dark Pattern
Only 15 left in stock	Scarcity
Limited Quantity	Scarcity
Cap Construction	Not Dark Pattern
 Need Help Finding The Right Product? 	Not Dark Pattern
Body Washes	Not Dark Pattern
ONLY 2 LEFT	Scarcity
Matthew in Charleston, South Carolina just purchased The Puffy Lux Mattress	Social Proof
LIVE REMAINING STOCK	Scarcity
Brand: NFL Pro Line by Fanatics Branded	Not Dark Pattern
339 users are currently active on our website	Social Proof
Please Order Within: 0 0 : 0 2 : 4 1 : 10 65	Urgency
Baby Boy Jumpsuits and Rompers	Not Dark Pattern
Nah, I'll pay full price	Misdirection
Like many websites, we share certain information, such as your IP address, device ID or similar online identifier, with certain third parties, such as social networks and advertising networks. This information is used to personalize advertising you see after you‚Äôve visited our website. The California Consumer Privacy Act (‚ÄúCCPA‚Äù) considers our sharing of that information in this manner to be a ‚Äúsale.‚ÄùFor more information about the First and Third Party Cookies used please follow this link.	Not Dark Pattern
Choose which store you would like to visit	Not Dark Pattern
You may cancel or renew your membership to the VIP Program or find out more information about your VIP Program subscription, including your annual expiration date, by contacting support@grove.co.	Obstruction
No Thanks, I like paying full price.	Misdirection
Popular Item! üî• 16 people are viewing this and 18 recently purchased it.	Social Proof
Ida in Tangerang Selatan, Indonesia purchased Iseya VG10 G-Series 33 layer Damascus Japanese Chef's Santoku Knife , 180mm about 1 hour ago	Social Proof
3 items left	Scarcity
ONLY 52 items left in stock!	Scarcity
Cracked Nipples	Not Dark Pattern
Only 2 left in stock	Scarcity
Fave x GrabPay	Not Dark Pattern
No thanks, I'll pay full price!	Misdirection
If you wish to cancel a membership, please contact our Customer Services Department on UK: +44 808 164 8264 (standard local call charges will apply) or via email on customer.service@beautypie.com. You can also contact the Customer Services Department by post at: Beauty Pie Limited, Customer Service Department, The Point, 210 New Kings Road, London SW6 5NZ, United Kingdom. Please quote your order number in all correspondence.	Obstruction
Only 4 left In Stock	Scarcity
 Flex Mount 	Not Dark Pattern
2,229 people have viewed this item	Social Proof
Someone in Castle Hill bought a Philips Essential LED Downlight Kit | 5W 4000K few hours ago.	Social Proof
FOR THE ULTIMATE EXPERIENCE: (Can select more than one)	Misdirection
 Related Categories 	Not Dark Pattern
from France	Not Dark Pattern
308 viewed per day	Social Proof
Mom & Baby	Not Dark Pattern
This is in 5 other carts.	Social Proof
STOCK IS GUARANTEED FOR 60 MINUTES	Urgency
Please add products to see your site in action	Not Dark Pattern
BSA FAC Air Rifles	Not Dark Pattern
Only 2 units left!	Scarcity
style to command	Not Dark Pattern
Only 5 left in stock	Scarcity
LIMITED TIME: FREE SHIPPING LOWERED TO ORDERS OVER $69.95!	Urgency
sweatshirts	Not Dark Pattern
On Sale! Limited Time Offer!	Urgency
Sierra in Cypress, California bought Beauty In All Dress, Dusty Blue about 46 minutes ago	Social Proof
 Ladies Flower Print Casual Fashion Dress 	Not Dark Pattern
"If you click continue below we will be happy to tell you about discounts, money off and new products from Very by e-mail and text,
unless you tell us you DO NOT want to hear about them, by ticking here.
If you would like to receive offers from carefully selected 3rd parties, please tick here"	Misdirection
Bath Bombs & Salts	Not Dark Pattern
Wall art	Not Dark Pattern
Bath Decor	Not Dark Pattern
Free Shipping	Not Dark Pattern
Household	Not Dark Pattern
An item you ordered is in high demand. No worries, we have prioritized your order.	Scarcity
60% OFF ENDS IN DAYS HOURS MINUTES SECONDS	Urgency
Keep up with crankbrothers	Not Dark Pattern
Casual Sheath Chiffon Sequins Straps V-neck Sleeveless Bridesmaid Dress	Not Dark Pattern
No thanks, I don't like savings	Misdirection
We use cookies to give you the best experience possible. No personal information is stored. Using this website means that you are ok with this cookie policy.	Not Dark Pattern
218 people have added this item to cart	Social Proof
QUICK! ONLY 1 LEFT IN STOCK	Scarcity
Only 1 Left !	Scarcity
 Port, Sherry & Sweet Wine 	Not Dark Pattern
No thanks, I prefer to pay more for shoes!	Misdirection
Engine Cooling System	Not Dark Pattern
ONLY 5 LEFT	Scarcity
How/why the homepage uses cookies	Not Dark Pattern
 mens long sleeve organic shirt 	Not Dark Pattern
These cookies are usually set by our marketing and advertising partners. They may be used by them to build a profile of your interest and later show you relevant ads. If you do not allow these cookies you will not experience targeted ads for your interests.	Not Dark Pattern
20% OFF VALENTINE\u2019S DAY FAVOURITES * | LIMITED TIME ONLY	Urgency
 EDC-V Megalodon Bottle Opener - Brass (Exclusive)	Not Dark Pattern
Availability: Low in stock today	Scarcity
NO THANKS	Misdirection
 Motocross Gloves 	Not Dark Pattern
Popular item! üî• 27 people recently purchased this.	Social Proof
 All consumers in the EU are charged VAT on the purchase of goods and services.	Not Dark Pattern
105 pawrents are buying for their furkids now!	Social Proof
Compare at	Misdirection
*Only 2 left in stock. Don't miss out!	Scarcity
 No reviews yet Write a review 	Not Dark Pattern
 Continue with Facebook Continue with Google 	Not Dark Pattern
 TERMS OF SALE 	Not Dark Pattern
NO THANKS, I DON'T WANT TO SAVE MONEY	Misdirection
Back Yard & Spa	Not Dark Pattern
Low Stock! Only 3 left.	Scarcity
 PopGrip Antimicrobial Refine by Product Type: PopGrip Antimicrobial 	Not Dark Pattern
 Customer Support 	Not Dark Pattern
25% OFF SELECTED JACKETS Limited Time	Urgency
117 people have viewed this item in the last 7 days.	Social Proof
41 people have looked at this in the last couple of hours	Social Proof
Only 1 left in stock! Order soon!	Scarcity
New Rifles	Not Dark Pattern
Limited Time Promo $194.00	Urgency
Nightforce New Year Clearance	Not Dark Pattern
SUPPORT THE AMERICAN SUPRESSOR ASSOCIATION	Sneaking
Custom Board Quote	Not Dark Pattern
 Charity Collection 	Not Dark Pattern
James from Colonia purchased a	Social Proof
$132.90 $99.00	Misdirection
Graphic T-Shirts	Not Dark Pattern
 Landofcoder can power almost ANY marketplace you think of	Not Dark Pattern
I always order from them! Such good quality for the price you pay! Will always be back!	Not Dark Pattern
I have not had my hair so soft and shiny in such a long time and my grey was completely covered! So incredibly happy.	Not Dark Pattern
 Excellent service all round 	Not Dark Pattern
View all	Not Dark Pattern
 ÈüìÂúãÈ¶ôÊ∞õ Cosmic Mansion 	Not Dark Pattern
Nighty For Honeymoon	Not Dark Pattern
HURRY, ONLY 1 LEFT!	Scarcity
Shop All Vape Kits	Not Dark Pattern
 Shoe Care 	Not Dark Pattern
No thanks, I don't want to save up to 75%	Misdirection
Tristan in Markham, Canada purchased a Dragon Baseball Jersey	Social Proof
THE SET INCLUDES:	Not Dark Pattern
 Short	Not Dark Pattern
7 left in stock	Scarcity
Be part of the best family ever & enjoy 15% in VIP Benefits on every order, every day. That's 10% Instant Savings plus 5% back in Rewards Cash on everything. Plus, enjoy 90 days to test run your shoes, socks, and insoles. And so much more! Join today for just $1.99 your first year.  	Sneaking
Add to Wish List(13 People Have Added)	Social Proof
Womens Plaid Clothing	Not Dark Pattern
Embossing Powder	Not Dark Pattern
No thanks, I want to pay the full price.	Misdirection
Only 1 item left!	Scarcity
Mounif in Pittsburgh, United States purchased	Social Proof
Your order is reserved for 09:43 minutes!	Urgency
Platinum-Dipped Rose	Not Dark Pattern
5 LEFT	Scarcity
No thanks, I prefer to pay full price.	Misdirection
Rs 4,013 (Retail Discount) + Rs 2,997 (Limited Time Coupon)	Urgency
 A-Z Luxury Brands 	Not Dark Pattern
 Fashion Short Sleeve Crew Neck Print Dress 	Not Dark Pattern
We have 1 left in stock	Scarcity
12 recently purchased it.	Social Proof
 Wife 	Not Dark Pattern
By signing up via text, you agree to receive recurring automated promotional and personalized marketing text messages from SPANX¬Æ. Msg & data rates apply. View Terms of Use & Privacy Policy.	Not Dark Pattern
0 DAYS22 HOURS13 MINUTES21 SECONDS 	Urgency
 Articles: Medical Matters 	Not Dark Pattern
Only 5 left , In Stock	Scarcity
Jamie from Eloy United States purchased a CBD Oil Vape Additives 4 Pack About 7 hours ago	Social Proof
251 people are viewing this right now	Social Proof
All Girls Clothing	Not Dark Pattern
Join the Team	Not Dark Pattern
Vintage Fancy Red Bracelet Watch Women's	Not Dark Pattern
HURRY ONLY 1 ITEM LEFT!	Scarcity
What Are Healing Crystals?	Not Dark Pattern
404 Orders	Social Proof
Carpet Python Vivariums	Not Dark Pattern
50% OFF Everything (yep, even sale) + $5.99 Shipping* ENDS IN 12h 13m 56s	Urgency
Tyler in Norwalk, United States purchased a	Social Proof
Someone in Pittsworth bought a Ultimate COLT Anal Training Kit 2 hours ago	Social Proof
#6 Bestseller in Rugs This item was viewed 92 times in the last day.	Social Proof
Someone in Shelby twp, United States just bought Galaxy Note 8 10000mAh ZeroShock Battery Case 3 days ago	Social Proof
Charleston 	Not Dark Pattern
Power Button Covers	Not Dark Pattern
(Only 1 left!)	Scarcity
Discreet packaging	Not Dark Pattern
How do I cancel my membership? We are confident you will enjoy your Premium Membership. If for any reason you are not completely satisfied within the first 30 days of your paid Annual Membership, we will refund 100% of your membership fee no questions asked. After 30 days we will refund your membership fee on a pro-rated basis. There are no refunds on Monthly Memberships. To obtain a refund, please contact us at 1-855-253-0822 or by email at wwgoasubscription@program-director.net.	Obstruction
Last one available	Scarcity
Mens Footwear	Not Dark Pattern
 Upcoming Events 	Not Dark Pattern
Beetle Remotes	Not Dark Pattern
Free People	Not Dark Pattern
Carol in St. Louis, Missouri bought Original USB Charging Anti-Theft Backpack	Social Proof
ONLY 4 LEFT IN STOCK	Scarcity
Shop All Golf Balls	Not Dark Pattern
Sunglasses and Eyewear	Not Dark Pattern
 Gut Health 	Not Dark Pattern
Dog Collars, Leads & Tethers	Not Dark Pattern
 Naked Wolfe 	Not Dark Pattern
How about these?	Misdirection
Only 14 left in stock	Scarcity
 Optimized Patch System 	Not Dark Pattern
Product Tagline	Not Dark Pattern
Anniversary Gifts 	Not Dark Pattern
No, thanks, I¬¥d rather pay more	Misdirection
Someone in Culgoa, Australia purchased Savelli Epic Mens Comfortable Leather Lace Up Boots Made In Brazil	Social Proof
1 Left	Scarcity
I don't want a discount	Misdirection
Healthy Diet	Not Dark Pattern
No, thanks. I don't like great deals.	Misdirection
Someone in Paris, France just purchased a Kanpeki Knife Set	Social Proof
 WWE New Arrivals 	Not Dark Pattern
Alpha BRAIN¬Æ is a dietary supplement that helps support cognitive functions, including memory, mental speed, and focus.‚Ä†	Not Dark Pattern
Someone in Ampang, Malaysia just bought	Social Proof
Trey in Columbia, United States purchased Leather Cord Capsule	Social Proof
THE COMPETITION $1,299.99	Misdirection
ONLY 5 LEFT!	Scarcity
Hurry Low Stock	Scarcity
Items will be reserved in your cart for 19:10	Urgency
1 people are viewing this currently	Social Proof
No thanks, I‚Äôll skip this amazing super-saver deal. I don‚Äôt need so many beautiful textures	Misdirection
 SAA Oil & Acrylic Brushes 	Not Dark Pattern
1 left, order now!	Scarcity
Vacation One Shoulder Loosen Long Sleeve Woven Dress	Not Dark Pattern
Lip Balms & Treatments	Not Dark Pattern
Price Guaranteed For DAYS/HRS/MINS/SECS	Urgency
Other Applications	Not Dark Pattern
No thanks, I don‚Äôt want to save	Misdirection
High Gable Sheds	Not Dark Pattern
Wondering where to buy White Cloud products in the U.S.? Our distributor list is growing! Bookmark our list and stay tuned!	Not Dark Pattern
 Products 	Not Dark Pattern
Dressmakers Mannequins 	Not Dark Pattern
Wait! YOUR CART QUALIFIES FOR 15% OFF YOUR ENTIRE ORDER. Offer Expires in: 2955	Urgency
No thanks, I will pay full price.	Misdirection
 Air Purifying Plants 	Not Dark Pattern
All Little Boys Clothing	Not Dark Pattern
 Our Story 	Not Dark Pattern
2 left	Scarcity
History Of The NRA	Not Dark Pattern
25% OFF* ENDS IN 00 : 12 : 27 : 15 DAYS HRS. MIN. SEC.	Urgency
Start SellingSearchWishlistAccountCartCart	Not Dark Pattern
61 people have already bought that product today with 50% discount	Social Proof
89 currently viewing	Social Proof
Used Leica Cameras	Not Dark Pattern
Purchased 8 times in the last few days.	Social Proof
Jonathan in Syracuse, United States just bought Electric Skateboard Battery Pack 36V 10S2P 4 hours ago	Social Proof
View All Bearings	Not Dark Pattern
Low in stock: only 1 left.	Scarcity
American Diamond Earrings	Not Dark Pattern
 cm in 	Not Dark Pattern
Personalize your doll	Misdirection
 sales@scandinavianoutdoor.com 	Not Dark Pattern
 Searching...	Not Dark Pattern
Flat Iron	Not Dark Pattern
You can feel confident that your new box each month is helping you celebrate pregnancy and protect your bump!	Not Dark Pattern
Availability: 5 items left	Scarcity
Someone from Osijek, Croatia just bought TMC CP Style Single Pistol Pouch	Social Proof
 View product View SAA Standard Membership Renewal - Credit/Debit Card - One Year Only 	Not Dark Pattern
The World Fair Trade Organization Label guarantees that People Tree follows Fair Trade best practices in our organisation.	Not Dark Pattern
Packed with Super Citrimax	Not Dark Pattern
No thanks, I don't want to look my best	Misdirection
Check your orders, in-store quotes & more	Not Dark Pattern
Thermostats	Not Dark Pattern
Want more inspiration and styling tips? Dive into The Southern Edit, Southern Tide‚Äôs lifestyle blog, and follow us on social media. 	Not Dark Pattern
The Wizard of Oz	Not Dark Pattern
ONLY 5 LEFT, ORDER SOON!	Scarcity
Prices shown for delivery to JAPAN Change delivery country	Not Dark Pattern
Barbour International	Not Dark Pattern
70% offers claimed. Hurry up!	Scarcity
Only 1 Left!	Scarcity
M-Class Remotes	Not Dark Pattern
Sorry, this is out of stock. You just missed it.	Scarcity
Your order is reserved for 19:57 minutes.	Urgency
Clearance Optic Accessories Deals	Not Dark Pattern
Hurry! Limited Quantity Available.	Scarcity
I wish to Start Shopping but I don't want to receive daily email alerts about your amazing discounts on luxury brands.	Misdirection
Jessica in Orange, United States purchased a Black 1920s Sequin Maxi Flapper Dress 12 minutes ago	Social Proof
3 Left!	Scarcity
Highline Double Wheel Bag	Not Dark Pattern
Only 5 Left	Scarcity
Only 1 left in stock - Order soon	Scarcity
Only 1 left.	Scarcity
 Soft Toys 	Not Dark Pattern
ONCE IT'S GONE, IT'S GONE	Scarcity
Lease to Own conditions	Not Dark Pattern
Full HD 144Hz IPS Anti-Glare (1920 x 1080) FREE Upgrade (Limited time offer!)	Urgency
EXTRA -30% OFF WITH CODE: EXTRA30 Ends in: 0 0 0 0 days 0 0 4 4 hours . 0 0 9 9 min . 2 2 8 8 sec	Urgency
Elegant A Line Short Sleeve Satin Bateau Floor-length Mother of the Bride Dress with Ribbon	Not Dark Pattern
Tidal Waves Collection	Not Dark Pattern
POPULAR 62 others checked this out in the last few hours.	Social Proof
Trowels & Putty Knife	Not Dark Pattern
Gifts By Price	Not Dark Pattern
"No thanks! I'd rather join the """"Pay Full Price for Things"""" club."	Misdirection
 PopWallet+ Refine by Product Type: PopWallet+ 	Not Dark Pattern
FootwearHome & Office	Not Dark Pattern
Get 20% off Sample Doors! √óOffer Ends In 58 : 29 Use Promo Code sample20off	Urgency
HURRY! ONLY 11 LEFT IN STOCK.	Scarcity
Hurry up! 22 people other than you have this product in their cart	Social Proof
 family 	Not Dark Pattern
Kinky Curly Wigs	Not Dark Pattern
Devices 	Not Dark Pattern
Merchandise: $69.99iService Charge: $14.99 Total Before Tax: $84.98 Estimated Tax:$5.63Order Total: $90.61	Sneaking
 Digital Device Covers 	Not Dark Pattern
Pleated Skirts	Not Dark Pattern
beautifully written prose	Not Dark Pattern
4 days 05:46:20	Urgency
Corporate Responsibility Report	Not Dark Pattern
 ÊâãÈå∂ / Watches 	Not Dark Pattern
Only 69 left!	Scarcity
52 people have added this product to bag in the last 72 hours	Social Proof
156 sold in last 24 hours	Social Proof
BROKEN REMOTE? FIX IT YOURSELF AND SAVE HUGE	Not Dark Pattern
Offer ends 0Hours:04Minutes:46Seconds	Urgency
COMBAT GEARHot	Not Dark Pattern
1,446 people have viewed this item	Social Proof
Order in 14:53 to get 2 pillows for free	Urgency
HURRY ONLY 9 LEFT IN STOCK!	Scarcity
only 1 in stock	Scarcity
Grey Jewelry	Not Dark Pattern
 Select shake flavor: 	Not Dark Pattern
ON SALE AT $1.99 FOR A LIMITED TIME	Urgency
Submitted by Fermin Larracilla P√©rez	Not Dark Pattern
Polycarbonate	Not Dark Pattern
Browse by A-Z	Not Dark Pattern
 Other Snacks 	Not Dark Pattern
Less than 6 items left	Scarcity
Ken in Oakland, United States purchased a Dreamville Hoodie a month ago	Social Proof
Other Promotions	Not Dark Pattern
Recommended	Not Dark Pattern
17 people have added this item to cart	Social Proof
Free Shipping. Limited Time Only. for orders over $50	Urgency
Set SALE Into¬†Summer 	Not Dark Pattern
 IZZY MIDI DRESS Ivory 	Not Dark Pattern
 Gold Refine by Color: Gold 	Not Dark Pattern
View All Homeware	Not Dark Pattern
Site Wide Savings for the Entire Family! Pricing is off Rogan's Shoes every day Low Prices! Prices are already reflected on the site. Limited time only! Restrictions apply. Online Only.	Urgency
00 DAYS 00 HOURS 29 MINUTES 26 SECONDS	Urgency
 Explore more styles from this printspiration 	Not Dark Pattern
Hurry! Only 2 Left	Scarcity
1 LEFT IN THIS SIZE	Scarcity
Hurry, only 6 left in stock!	Scarcity
Sponges, Mitts & Bath Brushes	Not Dark Pattern
Crystal Lotus Sriyantras 	Not Dark Pattern
No thanks. I don‚Äôt want to save money.	Misdirection
Other CollectiblesPhotos	Not Dark Pattern
Need a Hand?	Not Dark Pattern
Hurry !! Only 52 left in stock	Scarcity
Free 60 day VIP trial membership with this order. Cancel anytime.	Sneaking
Purchase Benefit Club Member can cancel the Purchase Benefits at any time by calling MDG‚Äôs Customer Service department at: 1-800-906-0975 ext. 352 and requesting to cancel the Purchase Benefits.	Obstruction
lego harry potter	Not Dark Pattern
Most of our orders are from repeat customers.	Not Dark Pattern
New In Bottoms	Not Dark Pattern
Want to add one of these?	Misdirection
 Base Layer & Thermals 	Not Dark Pattern
FANSTASTIC DEALS	Misdirection
Alyssa in San Antonio, United States purchased a iTunes Japan Gift Card 10000 JPY about 35 minutes ago	Social Proof
'Keeper of Lost Things'	Not Dark Pattern
GlassGuard Warranty Do not fear breaking your glass! Add our GlassGuard warranty policy for just $3.85 and we'll insure this purchase.	Misdirection
Hair Care Remedies	Not Dark Pattern
In Stock (8) Left	Scarcity
 Paul Henry 	Not Dark Pattern
Cincinnati Bengals T-Shirts	Not Dark Pattern
Compare Products 	Not Dark Pattern
Sexy A Line Short Sleeve Sequins Off-the-shoulder Floor-length Mother of the Bride Dress with Split Front	Not Dark Pattern
Fancy some creative inspiration, news and offers? Sign up for SAA enewsletters today.	Not Dark Pattern
 Sports Bras 	Not Dark Pattern
Purchased 100+ times in the last few days.	Social Proof
Accessibly App features	Not Dark Pattern
Scarves & Snoods	Not Dark Pattern
Your cart is reserved for 14:05 minutes!	Urgency
 OH SHIP! Looks like that page wasn't found 	Not Dark Pattern
Only a few left!	Scarcity
In Stock Only 5 left!	Scarcity
Exotic Bird Food	Not Dark Pattern
Limited Time	Urgency
AN ITEM IN YOUR CART IS SELLING OUT QUICKLY	Scarcity
iPhones	Not Dark Pattern
Either because we're updating the site or because someone spilled coffee on it again. We'll be back just as soon as we finish the update or clean up the coffee.	Not Dark Pattern
Hurry Up! Only 1 Piece Left	Scarcity
LIMITED OFFER: $125 Off + 2 Free Pillows	Urgency
Want Free Shipping?	Misdirection
 Summer Simple Breathable Socks 	Not Dark Pattern
Sellout risk:	Scarcity
No thanks, I don‚Äôt like saving money.	Misdirection
Value of Product	Not Dark Pattern
00DAYS07HOURS09MINUTES39SECONDS	Urgency
Someone from purchased a HOLEES Original Ladies II - Navy About 9 hours ago	Social Proof
 Mountboard 	Not Dark Pattern
Graduations	Not Dark Pattern
 Light powerful. 	Not Dark Pattern
Availability: Low Stock 4 Remaining	Scarcity
Items in your cart are in high demand. But we have reserved your order.	Scarcity
Viewed 744 times today	Social Proof
Only 2 Left in Stock	Scarcity
1044 sold in past 12 months	Social Proof
Cropped Jeans	Not Dark Pattern
64 users bought this product Touch: The Set - Touch XL & TouchUp Makeup Mirror Bundle	Social Proof
Someone in Joliet, Illinois purchased a Yocan Evolve Plus XL Vaporizer	Social Proof
Jeanne E. Bray Memorial Scholarship	Not Dark Pattern
Samuel in Minneapolis, United States purchased a Pod Juice Jewel Mint Cool ‚ùÑÔ∏èNicotine Salt e-Liquid 15/30ml 7 hours ago	Social Proof
 Boardshorts	Not Dark Pattern
The site was easy to navigate. I haven't received my shoes yet, but overall a good experience.	Not Dark Pattern
Cheaney	Not Dark Pattern
 ‚â° Filter Reviews Clicking on the following button will update the content below 	Not Dark Pattern
Arthritis Aids	Not Dark Pattern
Camo Shirts & T Shirts	Not Dark Pattern
SELLING FAST! GET 10% OFF THIS ITEM. ACTIVATE NOW.	Scarcity
TRE by Natalie Ratabesi	Not Dark Pattern
LIMITED TIME OFFER	Urgency
Sign Up To Our Newsletter To Receive News, Offers And Promotions.	Not Dark Pattern
Someone from Cape Town, Western Cape, South Africa just started buying Packable Travel Duffel Bag! 5 minutes ago	Social Proof
Offer ends in 9hrs 55min 29sec!	Urgency
(LIMITED TIME OFFER) TORSION GUN HOLSTER SUPER COMBO	Urgency
 Sale By Category 	Not Dark Pattern
Floral Cross Stitch & Embroidery Kits	Not Dark Pattern
Your AccountTrack Your OrdersJoin Celebrations Passport	Not Dark Pattern
Dog Whistles & Lanyards	Not Dark Pattern
Hurry! Only 1 left in stock	Scarcity
1 people bought Jotter To Do Refill in the last few hours	Social Proof
Other people want this. 10 people have this in their cart right now.	Social Proof
 Terms of Use Privacy Policy Do Not Sell My Personal Information Request My Personal Information 	Not Dark Pattern
Colors	Not Dark Pattern
Manage Consent Preferences	Not Dark Pattern
Select Occasion close	Not Dark Pattern
1 person is looking at this item.	Social Proof
LIMITED TIME OFFER! FREE SHIPPING OVER $99 + FREE RETURNS*	Urgency
994 items sold this hour.	Social Proof
View All New Arrivals	Not Dark Pattern
How White Cloud Prevents E-Cig Sales to Minors Read More ‚ûû	Not Dark Pattern
Someone in Petaling Jaya, Malaysia just bought SNEAKERGUARD Midsole Paint Marker - BOOST White	Social Proof
Availability: Low Stock	Scarcity
Low Stock	Scarcity
Influencer Program	Not Dark Pattern
View All Apartment	Not Dark Pattern
72% offers claimed. Hurry up!	Scarcity
(Only 1 Left)	Scarcity
I accept the Terms & Conditions of the FREE Brother Care Program and agree to receive exclusive offers and general promotions from Brother. I may withdraw my consent at any time.	Forced Action
Someone in Red Cliffs bought a RHK Yamaha YZ/YZF/WRF 99-16 Blue Pursuit Footpegs 3 minutes ago	Social Proof
limited availability at this price!	Scarcity
WilmaNorth Carolina	Not Dark Pattern
 TV & Home Appliances 	Not Dark Pattern
"Save 25% on your entire order 09 Hours 57 Minutes 34Seconds use code: SPRING25"""	Urgency
Wigsbuy- Online Beauty Store of Fashion Wigs, Hair Extensions & Accessories for Sale.	Not Dark Pattern
Quick Navigation	Not Dark Pattern
CHF	Not Dark Pattern
+ Performance Cookies	Not Dark Pattern
No I don't feel lucky	Misdirection
Ericdress Summer Patchwork Polyester Long Women's Tank Top	Not Dark Pattern
 More Sports 	Not Dark Pattern
 Bento Lunch Boxes & Food Containers 	Not Dark Pattern
 Clinical Studies 	Not Dark Pattern
 Accessories Collection 	Not Dark Pattern
3 LEFT	Scarcity
 Electric Daisy 	Not Dark Pattern
 VUSE Alto Menthol Pods 	Not Dark Pattern
Hurry! Only 2 left at this price!	Scarcity
Limited Time Offer	Urgency
NO THANKS, I DON'T LIKE FREE STUFF	Misdirection
I‚Äôve read and accept the terms & conditions * , I also authorize Bosley to contact me by phone or text utilizing automated dialing equipment, as well as by email or mail with information about appointments, products, services, news or promotions. I also agree to Bosley's Terms of Service. Otherwise, call Bosley at 800-985-6405 to request your FREE information kit or to schedule your FREE no-obligation consultation.	Forced Action
 Crystal Beads 	Not Dark Pattern
Last purchased at 11:19am today.	Social Proof
9 sold in last 4 hours	Social Proof
Less than 10 left in stock	Scarcity
¬∑ Physical Healing	Not Dark Pattern
WAX Jeans	Not Dark Pattern
 Sold out 	Not Dark Pattern
Only 1 piece left.	Scarcity
No thanks, I don't like good deals.	Misdirection
Only 5 pcs left!	Scarcity
Complete your purchase within the next 12:18 minutes and receive 10% off	Urgency
 All Clothing 	Not Dark Pattern
Rose Gold Shoes	Not Dark Pattern
33 sold in last 12 hours.	Social Proof
 Sign in & make your visit all about you 	Not Dark Pattern
3 Left	Scarcity
No thanks, I don't want discount	Misdirection
228 People Have Viewed This Product Recently!	Social Proof
Taxes and shipping will be estimated at checkout.	Not Dark Pattern
Shop all	Not Dark Pattern
HURRY! ONLY 58 LEFT IN STOCK!	Scarcity
Email us ASAP (like seriously) at getflat@flattummyco.com and we will do everything we can to update this for you. As soon as you order, we will send you a confirmation email so please check your details carefully.	Not Dark Pattern
Current Offers	Not Dark Pattern
Be the first to get updates as well as access to exclusive offers and promotions	Not Dark Pattern
Hayden near Princeton just bought!!!: CBD VEGAN GUMMIES	Social Proof
660 people have viewed today	Social Proof
Someone in Madrid, Spain just bought	Social Proof
 help@postergully.com	Not Dark Pattern
Sale Ends in 5 days 14 hours 42 mins 53 sec	Urgency
LOW STOCK: Only 1 left.	Scarcity
Men's Sports Bottoms	Not Dark Pattern
Only 16 Left in Stock!	Scarcity
 Shop By Shape 	Not Dark Pattern
$3,159.20 $3,949.00 Limited time only	Urgency
This link will open in a new window	Not Dark Pattern
Hurry Up ! Time is running out	Urgency
 Low Price Guarantee 	Not Dark Pattern
5 left	Scarcity
Someone in Arden Hills, United States purchased 120ml Young Napoleon | Best Strawberry Shortcake eJuice | Vaporham Lincoln eLiquid about 42 minutes ago	Social Proof
 Out of Stock! 	Not Dark Pattern
 Synthetic nicotine | Strawberry, kiwi & pomegranate 	Not Dark Pattern
Just BEE Queen	Not Dark Pattern
Would you like to buy more and save more?	Misdirection
FOR A LIMITED TIME ONLY	Urgency
 Track your order by entering your order number and email below or if you would like to create an account or log in (click here) 	Not Dark Pattern
Swedish Hasbeens	Not Dark Pattern
Someone in Tornado, United States just bought Fresh Melon Menthol 2 hours ago	Social Proof
Only 8 Left!	Scarcity
No Thanks, I Prefer Paying Full Price.	Misdirection
Unique and personalized products to go as yourself.	Not Dark Pattern
 Search Search 	Not Dark Pattern
Only 10 left in stock	Scarcity
Did you know we have an app? Create shareable art and custom PopSockets designs with our unique image editing tools.	Not Dark Pattern
John Boos	Not Dark Pattern
Limited time offer	Urgency
 Bar Stools	Not Dark Pattern
Get inspiration, new arrivals and the latest offers to your inbox.	Not Dark Pattern
11 people have purchased this item	Social Proof
2049 sold in the last 7 days	Social Proof
I don't like discounts	Misdirection
no thanks, I like paying full price	Misdirection
232 people are viewing this offer!	Social Proof
Prior to the automatic renewal and billing, we will notify you in advance (via the email you used at the time of enrollment) of (i) the pending renewal, (ii) the then current fees and charges applicable to the Passport Program, and (iii) where you may find more information about the Passport Program. We will also send you an additional email confirming your renewal. Should you elect not to renew your Membership, you may cancel at any time prior to the renewal by emailing us at passportmembership@1800flowers.com and your credit/debit card on file with us will not be charged. A confirmation email will be sent to you.	Obstruction
02 DAYS :23 HOURS :00 MINS :54 SECS	Urgency
1DAYS 04 HOURS 17 MINUTES 18 SECONDS	Urgency
LEGO Sondersets Saison Polybags Promotionals ExklusiveOpens in a new window or tab	Not Dark Pattern
Custom Kids Headwear	Not Dark Pattern
N++ is all about using your momentum to complete levels and get high scores, but in this sci-fi world, there‚Äôs a slew of inadvertently homicidal enemy robots trying to prevent you from completing your goal.	Not Dark Pattern
Sale ending in 0 days 04 hours 12 minutes 10 seconds	Urgency
Return my item	Not Dark Pattern
Baby Size Guide	Not Dark Pattern
127 People viewed this product this week	Social Proof
üî• 2 people are looking right now	Social Proof
 Drive and Focus 	Not Dark Pattern
Enter your email VIEW MY CODE OFFER EXPIRES IN: 0 minutes 00 seconds EXTRA 10% OFF	Urgency
161 people have viewed this item	Social Proof
Only 2 left.	Scarcity
Hurry! Only 7 left in stock.	Scarcity
Hot Offer. Limited Time	Urgency
 Gameday Collection 	Not Dark Pattern
Whoops! 	Not Dark Pattern
Only 1 Left in Stock!	Scarcity
Memory Cards	Not Dark Pattern
Rick in Columbia, United States purchased a	Social Proof
9 items left	Scarcity
Hurry up! Only 11 items left	Scarcity
Welcome Newcomer	Not Dark Pattern
Debby in Harpers Ferry, United States just bought: Icing Pen Decorating Tool	Social Proof
Grab yourself a bargain!	Misdirection
We are not currently accepting orders from outside of the UK.	Not Dark Pattern
Hurry! Only 1 left!	Scarcity
NRA Whittington Center Store	Not Dark Pattern
No Thanks, I prefer not to have a protection plan	Misdirection
New Vintage Stylish Belt Watch - Women	Not Dark Pattern
31 have it in their cart	Social Proof
 First to know about upcoming tastings & events 	Not Dark Pattern
 Why buy from us 	Not Dark Pattern
Plus Size Shirts and Blouses	Not Dark Pattern
People also buy this with	Misdirection
HURRY! ONLY 31 LEFT IN STOCK.	Scarcity
 A Date With Duchess 	Not Dark Pattern
Only 3 left.	Scarcity
Wish Your Loved Ones Instantly with Ferns N Petals International Services	Not Dark Pattern
We may also disclose your information to third parties who may contact you with details of other products and services which may be of interest. If you do not want your name and mailing details made available in this way please email opt-out@nextdirect.com	Obstruction
Order now, only 2 left in stock!	Scarcity
 PopGrip MagSafe Refine by Product Type: PopGrip MagSafe 	Not Dark Pattern
What's New By Category	Not Dark Pattern
 Active Filters English (United States) English (United States) ‚úò Remove Filter 	Not Dark Pattern
Someone in Chambersburg, Pennsylvania purchased	Social Proof
‚Ä∫ Sub Ohm Juice	Not Dark Pattern
2day 13:49:51 Left	Urgency
Hurry up! Sale Ends in	Urgency
B-Series Truck remotes	Not Dark Pattern
Red Tops	Not Dark Pattern
 JOINT Oil 	Not Dark Pattern
Limited Stock	Scarcity
Orthopedic	Not Dark Pattern
Retro Cordless Edison Bulb Lamp	Not Dark Pattern
93 PEOPLE HAVE BOUGHT THIS PRODUCT TODAY	Social Proof
Speed Lace Accessory Kit - Silver	Not Dark Pattern
No, thanks. I'd rather pay full price.	Misdirection
LIMITED TIME OFFER : Grab a Matching Pair & save up 60%!	Misdirection
Americas	Not Dark Pattern
Here to help	Not Dark Pattern
 Comfy and looks great 	Not Dark Pattern
Creators' Council	Not Dark Pattern
Yes! Upgrade my purchase	Misdirection
Jeremy in Warroad, United States purchased a	Social Proof
Kick those cravings	Not Dark Pattern
 Brushes + Tools 	Not Dark Pattern
Free climate compensated shipping & returns	Not Dark Pattern
Deal expires in: 03 hrs 25 mins 22 sec	Urgency
FREE SHIPPING // FOR A LIMITED TIME ONLY	Urgency
 Read More 	Not Dark Pattern
Location: Kansas City, MO	Not Dark Pattern
Find your local store, view opening hours and find out where you can get your latest pickup in-store!	Not Dark Pattern
only 5 left in stock!	Scarcity
Casual Wear	Not Dark Pattern
40% OFF EVERYTHING* ENTER: 40PLT + FREE SHIPPING OVER $80 HURRY! LIMITED TIME ONLY	Urgency
 Resend One time Pin 	Not Dark Pattern
Case Material	Not Dark Pattern
Natalie in Graham, United States purchased a FREE BTS Answer Magic Pillow about 1 hour ago	Social Proof
tedpullin	Not Dark Pattern
Custom Women's Apparel	Not Dark Pattern
Ask a Question	Not Dark Pattern
Discontinued Item	Not Dark Pattern
Order Subtotal $19.99 Standard Delivery $12.99 Care & Handling $2.99 Tax $2.38 Total $38.35 Savings Today $10.00	Sneaking
No I'd rather not hear about exclusive offers and discounts.	Misdirection
No thanks, I‚Äôd rather pay more	Misdirection
Only 3 left in stock!	Scarcity
 Don't leave without taking discount 	Not Dark Pattern
View your order history	Not Dark Pattern
What people are saying about us...	Social Proof
Hydration	Not Dark Pattern
Act now and save $12.99. Limited time only!	Urgency
Only 13 left!	Scarcity
If your JR Plus membership has renewed automatically, you have seven (7) days after payment is taken to cancel your annual membership. You must contact Customer Service at (888) 574-3576 within this window and not have made any eligible purchase using the JR Plus service. You will then be provided with a full refund of your membership fee for the renewal year and the JR Plus service will be cancelled from your account. If you cancel during any renewal year after the seven (7) day window expires, you are not entitled to any refund of the renewal fee, even if you have not made any eligible purchase during the renewal term.	Obstruction
Tick here if you do not want to receive Promotional Offers by Post Tick here if you do wish to receive Promotional Offers by email and/or SMS Tick here if you would like to receive Offers from selected third parties	Misdirection
40% OFF EVERYTHING* ENTER: 40PLT + FREE SHIPPING ON ALL ORDERS OVER $80 	Urgency
about us	Not Dark Pattern
 Microsoft Xbox One S Wireless Controller ¬ª 	Not Dark Pattern
Carports & Garages	Not Dark Pattern
You may cancel your membership at any time by calling us at at 855-861-2573 (6:00AM ‚Äì 5:00PM PST) or by emailing support@luckytacklebox.com. California residents may also cancel your subscription by accessing your Account through the Site.	Obstruction
Hurry, only 5 left	Scarcity
After trying several other shades of red, I‚Äôve tried this one and just love it. It is the perfect shade of brown with beautiful red highlights, very rich color, and very beautiful.	Not Dark Pattern
No thanks! I don't like deals	Misdirection
 Ireland EUR	Not Dark Pattern
Fashion Forward	Not Dark Pattern
You may cancel your Minted More membership at any time by contacting Minted Customer Service at www.minted.com/help. If you cancel your membership before your Minted More gift box has shipped, we will refund your full membership fee; provided that we may charge you (or withhold from your refund) the value of Minted More discount benefits used by you and your account prior to cancellation. If you cancel at any other time, your membership fee is non-refundable.	Obstruction
Optics and Mounts	Not Dark Pattern
Don't Know Pincode?	Not Dark Pattern
SALE ENDS IN 19 DAYS, 9 HOURS, 50 MINUTES, 54 SECONDS	Urgency
Your order is reserved for 29:52 minutes!	Urgency
NA-KD, White	Not Dark Pattern
Game Extraction & Prep	Not Dark Pattern
Golf Remotes	Not Dark Pattern
Baby Girl Shoes	Not Dark Pattern
 Books About Indian Culture 	Not Dark Pattern
For any other inquiries, Click here	Not Dark Pattern
Round Boards	Not Dark Pattern
LIMITED TIME ONLY	Urgency
Only 9 left!	Scarcity
Mher from San Angelo, TX Recently made a purchase with Crossrope	Social Proof
There's no obligation to buy as an Xtra VIP Member, nor is there any minimum number of months or commitment for membership. You can shop or ‚ÄòSkip‚Äô by the 5th of each month, and you can cancel your membership at any time by calling (855) SAVAGEX (open 24/7).	Obstruction
3 left in stock	Scarcity
No thanks. I love chaos!	Misdirection
 By Doug	Not Dark Pattern
No thanks, I like paying full price	Misdirection
Show Cart	Not Dark Pattern
Lean To Sheds	Not Dark Pattern
 Cordless Phones For Seniors 	Not Dark Pattern
ONLY 9 LEFT	Scarcity
No Thanks, I don't want official software at the best price.	Misdirection
 Bra Panty Set 	Not Dark Pattern
DressesFootwearHatsHoodies & SweatshirtsJerseysPantsSleepwear & UnderwearSwim CollectionT-ShirtsSale Items- View All -	Not Dark Pattern
Only 4 left in stock	Scarcity
Trending Players	Not Dark Pattern
10 Left in stock	Scarcity
